20230914;597;819;475;127;348;1
20230211;63;825;487;243;244;2
20211112;105;351;341;188;153;3
20220311;966;452;500;124;376;4
20230422;597;819;429;351;78;5
20221208;63;452;79;61;18;6
20230913;360;452;339;296;43;7
20230719;63;977;305;53;252;8
20230820;294;818;440;338;102;9
20230715;63;720;260;254;6;10
20250109;162;721;238;161;77;11
20220506;360;837;121;13;108;12
20230919;25;307;290;147;143;13
20221019;387;348;319;94;225;14
20220830;63;647;232;3;229;15
20230125;387;351;250;130;120;16
20221102;855;348;214;113;101;17
20230729;524;647;412;41;371;18
20220209;634;647;295;93;202;19
20230425;387;348;356;147;209;20
20221006;955;818;457;133;324;21
20230920;25;541;346;269;77;22
20230517;156;825;321;104;217;23
20220419;63;204;210;10;200;24
20220311;962;720;457;181;276;25
20230315;966;348;253;65;188;26
20220720;962;818;409;46;363;27
20230703;105;567;486;26;460;28
20211112;63;720;209;47;162;29
20230405;181;721;100;40;60;30
20220112;524;858;327;170;157;31
20220122;196;977;427;169;258;32
20221122;635;567;58;38;20;33
20220325;966;720;349;161;188;34
20221004;162;837;225;192;33;35
20230310;63;837;312;194;118;36
20230128;955;286;160;157;3;37
20220113;597;977;147;69;78;38
20220410;105;348;322;259;63;39
20211012;181;286;154;35;119;40
20211120;63;204;55;26;29;41
20220216;741;876;438;22;416;42
20221207;955;876;280;134;146;43
20221109;597;721;223;168;55;44
20220308;25;977;441;107;334;45
20230610;360;567;143;42;101;46
20221204;524;647;154;151;3;47
20221213;162;977;479;105;374;48
20220717;966;351;210;18;192;49
20221031;105;721;142;20;122;50
20220328;196;720;211;51;160;51
20221105;442;720;427;49;378;52
20230119;63;286;422;187;235;53
20211118;855;876;471;357;114;54
20230305;294;818;500;355;145;55
20221112;741;720;157;35;122;56
20230113;580;308;394;346;48;57
20240405;855;348;330;100;230;58
20230912;855;876;175;163;12;59
20230329;105;204;260;158;102;60
20230604;741;354;491;140;351;61
20220128;162;307;254;116;138;62
20230321;294;858;67;52;15;63
20230805;63;348;484;395;89;64
20230611;524;818;374;177;197;65
20230601;635;452;193;102;91;66
20211222;387;858;220;73;147;67
20240201;442;858;286;222;64;68
20211117;181;452;332;223;109;69
20220721;962;876;125;6;119;70
20220705;156;876;481;72;409;71
20220513;597;720;281;111;170;72
20230809;294;348;202;38;164;73
20220630;442;858;71;11;60;74
20230620;955;351;372;189;183;75
20230310;580;351;66;35;31;76
20230512;855;720;264;200;64;77
20220105;63;308;332;301;31;78
20230702;63;837;128;40;88;79
20230216;360;818;432;346;86;80
20220827;580;308;112;82;30;81
20221109;63;818;487;104;383;82
20230909;442;721;224;211;13;83
20230130;162;858;243;235;8;84
20230626;387;308;144;44;100;85
20221017;105;721;282;191;91;86
20221007;360;541;496;214;282;87
20230422;63;307;484;281;203;88
20230804;955;452;225;138;87;89
20230619;597;348;474;5;469;90
20230309;442;307;483;102;381;91
20230301;442;818;405;114;291;92
20230514;294;354;340;34;306;93
20250503;634;204;134;43;91;94
20230925;25;819;221;159;62;95
20230512;196;977;365;122;243;96
20221210;524;286;463;121;342;97
20230118;156;204;417;272;145;98
20221230;156;818;55;40;15;99
20220722;387;858;381;78;303;100
20220702;634;541;71;37;34;101
20230322;955;351;400;90;310;102
20220822;294;721;106;24;82;103
20211018;741;452;358;162;196;104
20230611;181;348;104;92;12;105
20220623;196;541;247;43;204;106
20230328;181;308;488;459;29;107
20221221;156;541;411;304;107;108
20220828;63;567;140;114;26;109
20220103;294;354;293;126;167;110
20211031;741;204;175;99;76;111
20221231;635;721;500;380;120;112
20220206;524;308;411;274;137;113
20230326;597;720;151;115;36;114
20211010;955;818;151;61;90;115
20230217;741;307;362;212;150;116
20220907;196;567;57;18;39;117
20220318;442;977;414;305;109;118
20210812;63;567;299;27;272;119
20220719;966;720;396;272;124;120
20230916;105;721;313;95;218;121
20230612;966;348;311;28;283;122
20230709;855;858;457;445;12;123
20220709;387;308;148;98;50;124
20230521;63;204;452;293;159;125
20221209;63;721;276;107;169;126
20231203;294;204;488;106;382;127
20250209;162;541;380;137;243;128
20211109;181;720;439;352;87;129
20211215;156;307;302;29;273;130
20230715;63;819;170;1;169;131
20221114;162;452;266;29;237;132
20220728;156;308;259;8;251;133
20220418;442;541;73;31;42;134
20220302;524;204;102;9;93;135
20230623;196;308;422;159;263;136
20230505;962;307;67;52;15;137
20220324;442;354;284;240;44;138
20220409;181;721;72;57;15;139
20220614;634;351;131;57;74;140
20230619;580;204;140;90;50;141
20230719;181;825;415;83;332;142
20220114;962;307;210;159;51;143
20220929;387;825;486;358;128;144
20220728;442;858;378;86;292;145
20230628;387;825;263;101;162;146
20230618;162;858;122;50;72;147
20220411;196;647;372;76;296;148
20240902;360;647;270;170;100;149
20220422;294;307;371;62;309;150
20230125;741;720;262;153;109;151
20230501;855;351;369;313;56;152
20230205;25;204;113;28;85;153
20230609;25;720;216;164;52;154
20220503;580;977;147;12;135;155
20221122;524;837;291;153;138;156
20230129;387;567;222;42;180;157
20230316;966;541;228;38;190;158
20211210;360;977;490;301;189;159
20221024;635;876;440;54;386;160
20230501;63;541;163;126;37;161
20220418;597;307;369;165;204;162
20220203;855;351;455;37;418;163
20211224;63;720;121;23;98;164
20211107;966;819;403;340;63;165
20230203;181;837;333;156;177;166
20220410;294;721;430;410;20;167
20211119;294;837;258;248;10;168
20230701;580;204;282;166;116;169
20220121;524;720;312;5;307;170
20220113;634;858;262;183;79;171
20220404;955;541;439;31;408;172
20220504;635;307;59;10;49;173
20230407;634;541;354;131;223;174
20221008;196;351;106;24;82;175
20220329;966;308;460;426;34;176
20221104;360;721;185;173;12;177
20220107;442;351;420;31;389;178
20230809;966;837;371;56;315;179
20230413;580;354;222;208;14;180
20230214;25;818;244;78;166;181
20211211;741;647;93;29;64;182
20230609;162;876;224;82;142;183
20230703;181;348;267;157;110;184
20230610;63;721;220;194;26;185
20230131;25;541;207;197;10;186
20211111;294;286;319;226;93;187
20250201;360;348;392;189;203;188
20220610;855;567;488;322;166;189
20211015;741;308;307;288;19;190
20230221;181;837;449;291;158;191
20221210;524;286;118;51;67;192
20211128;387;307;122;8;114;193
20220125;634;819;380;221;159;194
20221023;966;818;106;22;84;195
20221027;955;286;143;66;77;196
20221202;105;307;156;122;34;197
20230902;955;307;380;251;129;198
20230222;181;876;231;223;8;199
20230224;196;720;289;71;218;200
20221128;524;354;228;158;70;201
20230401;635;720;387;335;52;202
20220907;162;876;257;180;77;203
20230425;181;308;92;8;84;204
20230106;955;825;417;28;389;205
20230626;63;721;157;36;121;206
20221206;580;567;338;179;159;207
20230923;962;818;239;62;177;208
20220504;105;647;423;402;21;209
20230922;181;348;290;239;51;210
20230821;162;351;132;49;83;211
20230219;597;541;335;88;247;212
20230210;181;977;382;159;223;213
20220927;597;351;484;65;419;214
20221101;294;647;362;258;104;215
20220918;360;307;333;231;102;216
20221008;635;977;307;246;61;217
20221110;966;647;182;168;14;218
20220721;63;204;465;201;264;219
20230111;360;354;137;8;129;220
20220520;741;351;133;25;108;221
20211109;63;876;168;65;103;222
20221106;855;837;68;15;53;223
20220112;181;308;356;55;301;224
20230509;634;818;167;36;131;225
20220320;962;567;183;70;113;226
20221017;25;819;433;374;59;227
20220403;181;721;376;229;147;228
20230805;855;858;347;324;23;229
20221211;63;720;479;241;238;230
20230401;580;721;260;65;195;231
20220320;442;647;271;218;53;232
20220609;635;818;182;160;22;233
20230912;597;308;450;365;85;234
20230207;634;647;78;49;29;235
20220804;25;876;315;200;115;236
20221128;105;818;477;447;30;237
20220520;105;720;53;14;39;238
20220122;524;567;115;85;30;239
20220809;580;819;162;55;107;240
20211101;162;308;497;319;178;241
20220408;634;647;154;9;145;242
20211126;580;977;400;15;385;243
20211119;63;354;357;210;147;244
20220925;105;308;271;178;93;245
20230726;162;876;386;226;160;246
20230404;741;204;166;33;133;247
20211022;105;541;438;90;348;248
20230823;294;567;285;82;203;249
20220620;855;876;79;29;50;250
20220115;196;308;279;150;129;251
20221108;63;204;492;234;258;252
20230608;105;567;263;47;216;253
20220409;580;307;114;91;23;254
20220320;196;876;258;213;45;255
20220511;635;858;143;133;10;256
20221108;580;567;307;47;260;257
20230611;966;308;234;42;192;258
20221216;580;720;178;119;59;259
20230506;966;204;120;7;113;260
20220814;634;837;367;52;315;261
20211126;524;351;318;58;260;262
20220730;162;837;424;118;306;263
20220716;63;647;125;33;92;264
20230904;855;348;435;124;311;265
20211009;855;647;244;145;99;266
20240204;25;348;390;160;230;267
20221023;741;351;458;330;128;268
20210929;63;351;285;269;16;269
20230806;156;308;202;133;69;270
20230415;156;567;435;419;16;271
20211029;580;348;444;428;16;272
20211224;181;204;462;22;440;273
20220607;966;819;302;6;296;274
20221003;635;452;447;131;316;275
20221115;105;348;342;300;42;276
20230505;597;721;163;96;67;277
20230215;580;351;184;118;66;278
20211113;966;286;338;4;334;279
20220523;597;204;72;65;7;280
20221118;63;977;110;99;11;281
20220514;962;567;339;88;251;282
20230404;635;721;291;175;116;283
20221210;105;354;281;150;131;284
20230304;634;858;282;89;193;285
20230216;105;567;176;133;43;286
20211208;387;819;99;68;31;287
20230701;580;647;470;397;73;288
20230711;360;720;334;114;220;289
20230529;387;452;157;58;99;290
20230620;955;818;312;275;37;291
20230224;387;858;391;385;6;292
20220728;580;567;362;25;337;293
20220701;360;351;210;85;125;294
20221022;635;720;112;27;85;295
20220217;962;307;351;343;8;296
20220905;580;286;260;97;163;297
20220516;966;837;316;257;59;298
20230908;181;858;446;439;7;299
20230810;635;348;223;47;176;300
20221127;442;204;375;273;102;301
20220730;105;825;63;46;17;302
20220123;634;720;113;103;10;303
20230322;634;720;401;260;141;304
20220219;962;818;339;112;227;305
20230501;360;307;53;52;1;306
20230425;524;819;428;200;228;307
20230801;63;348;152;6;146;308
20230223;635;541;131;2;129;309
20220518;955;825;393;28;365;310
20230105;105;348;333;246;87;311
20220904;360;348;75;38;37;312
20220813;105;452;256;170;86;313
20230427;442;825;290;195;95;314
20230209;25;825;457;436;21;315
20230125;360;825;339;171;168;316
20230701;635;977;248;74;174;317
20230120;63;307;120;75;45;318
20220603;387;567;141;39;102;319
20220313;162;348;142;64;78;320
20220628;196;307;472;332;140;321
20230514;63;837;351;118;233;322
20220810;966;541;120;78;42;323
20221004;741;720;416;390;26;324
20241102;442;348;270;181;89;325
20211205;635;286;483;442;41;326
20220918;25;819;171;87;84;327
20230716;442;541;398;232;166;328
20221010;634;647;55;53;2;329
20220829;387;876;194;178;16;330
20220822;387;204;293;116;177;331
20211025;741;647;299;235;64;332
20230806;966;286;333;181;152;333
20220314;597;818;168;134;34;334
20230304;634;647;70;5;65;335
20211119;597;567;105;36;69;336
20231005;597;308;220;146;74;337
20220516;63;977;336;196;140;338
20230305;63;541;205;88;117;339
20220714;105;541;101;45;56;340
20221201;955;818;207;47;160;341
20221222;294;541;97;7;90;342
20220818;855;452;278;99;179;343
20230304;855;819;265;78;187;344
20220302;105;354;271;129;142;345
20220523;966;354;290;130;160;346
20220725;105;721;348;152;196;347
20211007;387;876;219;46;173;348
20230527;105;825;90;35;55;349
20211030;63;351;138;31;107;350
20220118;580;348;239;144;95;351
20221207;634;819;449;191;258;352
20220916;962;721;410;177;233;353
20220201;597;721;188;176;12;354
20220824;294;452;50;20;30;355
20220723;442;858;332;82;250;356
20220316;294;348;462;102;360;357
20220126;105;818;132;24;108;358
20221219;294;354;163;131;32;359
20220503;63;720;306;84;222;360
20230403;63;858;374;288;86;361
20230604;196;721;455;304;151;362
20230421;635;308;219;164;55;363
20230210;63;307;341;56;285;364
20230708;181;876;454;177;277;365
20220513;597;452;345;229;116;366
20230821;634;858;163;160;3;367
20220207;634;825;473;311;162;368
20220628;634;858;440;321;119;369
20220228;442;204;410;190;220;370
20220503;955;977;198;140;58;371
20220518;25;354;247;43;204;372
20220615;524;819;421;177;244;373
20211225;962;825;366;316;50;374
20220407;855;819;127;93;34;375
20230819;442;825;94;27;67;376
20221210;360;354;156;40;116;377
20230617;634;307;186;43;143;378
20230605;966;825;295;201;94;379
20211129;162;307;296;25;271;380
20221212;741;876;445;265;180;381
20220708;635;286;154;133;21;382
20220427;156;720;465;247;218;383
20230424;962;721;362;67;295;384
20230701;181;977;257;129;128;385
20230831;855;351;468;134;334;386
20240402;387;818;290;61;229;387
20220403;294;977;110;4;106;388
20211014;181;720;79;78;1;389
20220907;105;819;340;317;23;390
20210312;741;308;386;67;319;391
20230910;294;541;376;288;88;392
20220126;156;348;316;312;4;393
20230123;162;348;337;92;245;394
20230210;105;819;195;154;41;395
20230217;524;858;273;8;265;396
20230219;196;307;131;2;129;397
20220905;597;825;189;187;2;398
20230507;634;567;403;395;8;399
20230503;181;286;177;26;151;400
20211208;962;541;58;39;19;401
20230708;387;647;495;230;265;402
20240104;294;348;233;46;187;403
20230204;442;204;471;75;396;404
20230905;105;286;182;149;33;405
20230809;635;819;367;8;359;406
20220707;156;307;480;395;85;407
20220307;524;567;321;131;190;408
20230620;63;819;428;288;140;409
20211028;855;721;405;377;28;410
20230417;597;858;63;25;38;411
20220622;360;286;211;50;161;412
20221129;966;286;262;195;67;413
20221229;635;721;407;64;343;414
20220218;580;567;428;44;384;415
20211026;855;541;482;267;215;416
20220729;635;452;469;110;359;417
20230613;741;825;349;128;221;418
20221006;855;818;434;340;94;419
20221209;634;204;70;55;15;420
20211002;634;351;423;351;72;421
20250305;741;819;345;235;110;422
20220110;634;858;324;216;108;423
20230810;442;348;427;256;171;424
20230528;63;819;330;321;9;425
20220817;156;567;130;55;75;426
20230810;387;647;421;333;88;427
20220722;63;452;177;70;107;428
20220915;966;308;252;223;29;429
20220214;360;348;109;38;71;430
20211129;387;720;98;67;31;431
20220708;162;647;363;141;222;432
20230921;196;351;81;62;19;433
20211007;360;837;420;372;48;434
20230220;387;858;355;156;199;435
20230808;63;818;465;69;396;436
20230219;181;351;159;100;59;437
20211109;63;348;333;233;100;438
20220731;63;541;396;7;389;439
20220321;196;977;57;23;34;440
20230718;294;720;323;178;145;441
20221216;635;977;297;293;4;442
20230516;962;286;92;79;13;443
20240608;181;307;313;216;97;444
20220227;196;977;401;3;398;445
20210712;196;567;448;299;149;446
20230408;635;876;395;154;241;447
20220106;360;308;496;187;309;448
20230714;196;837;340;200;140;449
20220930;63;977;183;165;18;450
20221124;105;858;325;99;226;451
20230123;634;819;62;10;52;452
20230204;597;876;184;158;26;453
20221014;955;204;262;173;89;454
20240101;196;819;93;67;26;455
20220425;442;308;104;21;83;456
20220930;442;977;404;4;400;457
20211217;196;307;77;62;15;458
20221029;966;721;199;175;24;459
20230119;196;567;198;43;155;460
20230114;966;825;351;93;258;461
20221005;962;647;333;307;26;462
20211006;25;977;87;64;23;463
20211114;634;977;118;104;14;464
20221205;360;977;361;187;174;465
20230701;524;876;152;68;84;466
20220419;524;721;160;115;45;467
20220228;580;837;436;237;199;468
20230715;524;876;464;25;439;469
20220329;25;348;126;119;7;470
20230817;966;348;496;80;416;471
20230517;181;837;324;307;17;472
20230214;635;452;454;30;424;473
20220619;634;354;122;12;110;474
20230422;635;858;325;142;183;475
20220603;597;977;430;43;387;476
20220212;360;452;341;239;102;477
20230426;181;541;190;20;170;478
20220715;105;308;312;10;302;479
20211015;63;647;77;69;8;480
20220817;156;721;107;81;26;481
20220524;294;348;84;2;82;482
20230909;196;308;148;81;67;483
20230316;105;351;51;42;9;484
20230830;855;720;366;211;155;485
20211108;442;647;53;26;27;486
20220316;580;286;183;182;1;487
20221122;63;351;468;418;50;488
20220209;442;541;230;147;83;489
20230527;597;837;74;8;66;490
20230503;181;307;164;55;109;491
20230115;360;977;364;362;2;492
20230319;294;351;443;84;359;493
20230916;955;351;283;157;126;494
20230214;442;858;141;52;89;495
20220802;181;721;388;370;18;496
20211221;294;720;364;249;115;497
20230529;962;977;70;39;31;498
20230122;597;541;447;108;339;499
20220422;962;818;133;98;35;500
20230319;741;837;317;99;218;501
20220808;741;858;338;307;31;502
20220623;635;837;379;98;281;503
20221004;580;308;402;11;391;504
20231108;741;567;312;7;305;505
20230316;580;204;227;94;133;506
20211028;105;541;173;102;71;507
20220317;25;286;366;290;76;508
20220212;962;977;348;18;330;509
20220913;442;307;290;96;194;510
20221014;855;818;239;129;110;511
20221104;63;452;148;71;77;512
20220724;634;567;337;82;255;513
20220307;962;286;232;79;153;514
20211201;962;837;252;200;52;515
20230620;634;647;211;177;34;516
20220617;442;825;324;280;44;517
20230917;387;720;103;28;75;518
20230403;294;354;360;345;15;519
20240101;855;452;157;58;99;520
20230901;524;286;478;439;39;521
20211026;294;307;147;143;4;522
20230721;181;354;380;355;25;523
20230805;635;351;86;83;3;524
20230412;181;819;207;162;45;525
20220311;181;858;439;430;9;526
20221215;25;351;206;85;121;527
20220919;962;858;131;126;5;528
20220513;360;977;161;130;31;529
20230705;162;567;258;245;13;530
20230710;855;348;71;7;64;531
20211029;162;647;127;42;85;532
20230417;63;286;191;46;145;533
20220222;955;819;81;14;67;534
20230725;855;825;482;473;9;535
20211213;181;818;92;6;86;536
20230622;597;819;409;211;198;537
20211201;855;647;397;162;235;538
20220702;741;541;270;9;261;539
20211027;855;204;258;167;91;540
20230729;25;348;225;38;187;541
20230508;741;818;458;151;307;542
20220304;635;308;108;14;94;543
20220130;635;204;472;325;147;544
20210930;294;452;303;76;227;545
20220314;162;286;262;220;42;546
20220826;580;351;287;105;182;547
20221014;955;354;183;79;104;548
20221110;741;354;104;7;97;549
20230919;635;858;499;54;445;550
20230314;387;308;307;94;213;551
20220618;181;452;188;17;171;552
20230309;962;354;303;7;296;553
20220307;442;307;237;237;0;554
20220105;25;351;437;245;192;555
20230403;634;307;74;36;38;556
20230412;955;647;200;166;34;557
20230905;387;567;443;203;240;558
20211028;63;720;214;9;205;559
20220111;524;351;150;128;22;560
20221108;387;307;195;143;52;561
20230503;524;286;351;252;99;562
20211215;360;354;490;14;476;563
20230806;294;541;337;231;106;564
20220610;162;452;148;114;34;565
20230205;855;647;233;87;146;566
20220514;360;720;482;27;455;567
20221117;962;825;67;56;11;568
20240710;387;452;333;86;247;569
20220216;580;721;378;249;129;570
20220730;156;721;352;97;255;571
20230717;966;876;489;90;399;572
20220619;966;720;196;15;181;573
20221231;741;837;466;213;253;574
20211123;635;647;320;34;286;575
20220730;962;721;128;74;54;576
20230706;63;307;352;159;193;577
20220430;63;351;432;173;259;578
20220909;442;819;326;211;115;579
20230402;156;204;313;39;274;580
20220408;162;720;384;188;196;581
20221230;524;307;487;341;146;582
20230918;635;720;81;53;28;583
20220105;580;647;168;6;162;584
20230707;294;567;372;173;199;585
20220709;635;819;206;172;34;586
20221224;387;308;205;35;170;587
20230304;962;977;175;127;48;588
20211031;196;204;336;75;261;589
20220715;25;825;262;240;22;590
20220507;63;354;452;236;216;591
20221128;105;541;419;151;268;592
20211006;597;876;269;8;261;593
20220620;955;354;428;238;190;594
20220811;597;307;67;39;28;595
20230820;966;721;118;110;8;596
20220903;162;452;60;16;44;597
20220126;63;348;79;71;8;598
20230705;962;567;60;15;45;599
20230712;962;348;209;190;19;600
20211224;741;721;120;67;53;601
20220418;63;286;448;21;427;602
20221016;580;354;130;129;1;603
20221128;634;308;185;21;164;604
20230131;294;452;106;65;41;605
20220125;966;825;146;80;66;606
20220206;63;876;337;190;147;607
20230908;855;348;159;145;14;608
20230510;63;541;125;49;76;609
20230625;524;354;141;77;64;610
20230406;181;876;57;50;7;611
20220203;524;307;159;159;0;612
20220824;442;876;498;270;228;613
20220313;181;837;204;204;0;614
20230409;597;720;332;48;284;615
20220604;105;204;203;126;77;616
20220709;635;720;412;230;182;617
20220604;741;858;274;201;73;618
20230318;156;818;122;38;84;619
20230628;442;837;238;80;158;620
20230228;162;567;188;150;38;621
20230107;105;351;210;187;23;622
20220414;63;825;414;409;5;623
20220201;181;818;247;122;125;624
20230114;105;720;56;52;4;625
20221021;442;452;219;154;65;626
20220918;635;818;305;232;73;627
20211230;25;837;221;221;0;628
20230713;196;286;230;217;13;629
20230203;294;837;352;113;239;630
20211124;634;308;270;150;120;631
20221220;524;204;73;63;10;632
20220321;741;818;222;50;172;633
20220626;387;204;331;17;314;634
20220505;360;721;465;294;171;635
20230902;634;348;442;152;290;636
20230330;634;348;348;248;100;637
20250402;156;204;213;55;158;638
20220419;25;721;384;357;27;639
20230913;442;308;252;245;7;640
20211128;196;348;306;305;1;641
20230105;196;204;354;332;22;642
20240411;597;452;295;167;128;643
20230514;524;819;294;209;85;644
20220831;962;721;370;349;21;645
20220226;580;541;281;190;91;646
20220316;634;720;185;67;118;647
20230415;360;720;378;354;24;648
20211006;63;876;251;131;120;649
20221210;966;204;134;19;115;650
20230923;105;721;334;142;192;651
20220327;181;348;477;420;57;652
20220102;63;825;176;33;143;653
20211208;105;204;364;17;347;654
20220503;25;204;270;130;140;655
20220128;966;308;441;369;72;656
20230827;855;819;197;87;110;657
20211117;955;720;118;90;28;658
20220707;181;825;332;249;83;659
20230712;597;720;376;270;106;660
20220111;597;819;294;37;257;661
20230417;63;858;377;18;359;662
20230904;25;858;233;167;66;663
20220609;387;837;489;87;402;664
20230522;105;825;346;131;215;665
20220622;966;452;114;7;107;666
20230215;105;348;497;281;216;667
20221102;597;876;403;259;144;668
20230406;294;721;210;85;125;669
20230418;162;819;332;66;266;670
20230706;360;837;60;60;0;671
20230819;294;567;432;372;60;672
20220910;855;348;252;146;106;673
20220805;855;818;158;65;93;674
20211231;63;818;479;214;265;675
20230117;105;721;296;260;36;676
20230721;387;204;324;86;238;677
20220201;63;876;463;167;296;678
20211107;634;204;454;334;120;679
20220821;162;647;63;50;13;680
20220803;63;286;491;351;140;681
20230531;442;720;79;55;24;682
20221217;294;567;78;5;73;683
20211223;634;204;105;22;83;684
20230912;63;876;265;77;188;685
20230326;442;308;211;84;127;686
20230130;162;720;268;115;153;687
20221214;156;819;406;375;31;688
20230101;524;348;227;99;128;689
20230607;294;354;459;400;59;690
20220829;156;721;401;162;239;691
20230718;580;720;351;323;28;692
20211123;162;351;91;23;68;693
20211016;162;286;491;383;108;694
20230627;387;567;346;60;286;695
20220313;162;825;376;123;253;696
20230525;387;647;164;33;131;697
20221206;442;286;492;281;211;698
20230424;597;308;301;128;173;699
20220702;634;351;142;84;58;700
20220905;360;351;229;222;7;701
20220226;196;567;138;35;103;702
20220711;524;825;336;32;304;703
20220827;25;977;362;140;222;704
20220214;63;567;275;45;230;705
20230819;63;286;115;86;29;706
20230529;294;720;137;52;85;707
20220225;741;567;372;134;238;708
20211116;63;825;99;15;84;709
20220613;294;286;403;14;389;710
20220904;442;819;207;203;4;711
20220715;597;351;338;89;249;712
20230506;63;308;372;329;43;713
20230124;741;541;55;13;42;714
20230303;25;351;328;3;325;715
20220726;105;721;408;48;360;716
20211214;580;647;446;274;172;717
20230309;360;348;51;42;9;718
20211208;63;351;315;122;193;719
20220210;63;307;495;308;187;720
20220509;156;351;131;49;82;721
20220626;181;354;250;165;85;722
20221210;966;307;227;183;44;723
20230127;63;348;194;14;180;724
20240407;855;818;137;100;37;725
20240305;63;541;185;175;10;726
20220228;294;858;215;124;91;727
20211208;181;348;103;64;39;728
20240407;741;825;378;71;307;729
20240604;162;819;384;30;354;730
20211107;63;308;335;317;18;731
20230103;63;876;409;408;1;732
20250504;966;818;382;108;274;733
20230701;63;825;426;34;392;734
20220817;442;721;403;245;158;735
20230804;966;819;59;2;57;736
20211127;442;819;435;62;373;737
20220511;181;286;441;113;328;738
20220404;741;721;309;169;140;739
20220422;955;858;273;198;75;740
20240109;162;567;396;294;102;741
20230815;580;818;138;137;1;742
20241103;294;818;390;20;370;743
20230117;181;348;82;17;65;744
20221024;741;308;442;20;422;745
20220921;63;977;171;10;161;746
20220411;442;541;491;469;22;747
20221125;25;354;65;29;36;748
20220303;360;348;233;62;171;749
20230305;580;876;300;271;29;750
20220303;580;354;165;73;92;751
20220412;635;541;424;89;335;752
20230926;741;567;426;171;255;753
20221009;634;307;72;67;5;754
20230112;360;721;282;39;243;755
20230819;156;567;151;62;89;756
20220305;105;354;418;376;42;757
20220315;855;819;211;154;57;758
20230101;181;858;187;7;180;759
20211210;25;876;499;49;450;760
20221024;63;977;430;384;46;761
20230429;635;541;72;14;58;762
20221127;580;977;185;31;154;763
20211115;955;204;340;303;37;764
20230512;360;204;494;248;246;765
20230430;63;567;214;40;174;766
20230303;105;286;133;86;47;767
20221231;387;819;234;133;101;768
20230531;962;837;411;133;278;769
20220615;524;307;313;295;18;770
20220622;360;825;245;113;132;771
20220606;181;876;380;349;31;772
20250708;966;204;220;27;193;773
20220120;181;452;154;148;6;774
20211213;597;977;77;71;6;775
20220930;635;977;55;52;3;776
20230113;597;354;201;128;73;777
20220701;597;720;129;118;11;778
20220405;442;977;369;215;154;779
20220119;635;354;383;209;174;780
20220319;25;354;154;152;2;781
20221129;962;308;90;85;5;782
20220109;360;837;57;1;56;783
20211126;360;858;335;310;25;784
20230503;156;721;78;5;73;785
20210928;105;452;171;118;53;786
20230225;25;837;308;150;158;787
20230719;360;307;127;78;49;788
20230919;635;351;260;216;44;789
20221124;635;818;314;176;138;790
20220114;741;818;369;183;186;791
20240905;25;452;429;302;127;792
20230802;962;647;60;29;31;793
20221129;360;204;315;244;71;794
20221221;524;819;453;51;402;795
20221010;387;204;124;66;58;796
20230323;962;876;108;71;37;797
20240207;360;819;313;91;222;798
20220318;63;348;115;57;58;799
20230511;855;876;314;227;87;800
20220424;360;286;397;40;357;801
20221224;962;354;247;141;106;802
20220905;962;351;290;22;268;803
20211120;955;204;362;160;202;804
20220504;966;876;221;108;113;805
20230326;181;308;53;34;19;806
20211219;442;567;345;133;212;807
20230331;962;647;132;20;112;808
20220308;156;876;393;364;29;809
20211110;63;567;372;86;286;810
20230702;955;876;456;114;342;811
20211228;25;721;145;117;28;812
20230615;63;204;473;292;181;813
20211031;294;721;401;312;89;814
20230609;156;286;364;329;35;815
20211124;966;308;245;25;220;816
20211213;962;647;141;42;99;817
20230317;156;825;338;332;6;818
20240603;294;308;226;35;191;819
20221215;580;348;268;64;204;820
20211029;442;837;280;121;159;821
20230511;634;825;403;142;261;822
20230406;855;308;500;155;345;823
20220830;294;858;311;262;49;824
20230725;855;858;240;118;122;825
20230607;387;308;196;61;135;826
20230202;25;348;437;424;13;827
20220727;962;977;246;87;159;828
20221122;962;541;218;25;193;829
20221219;196;818;428;89;339;830
20220827;634;348;445;393;52;831
20220611;955;348;78;60;18;832
20221124;63;876;206;58;148;833
20220921;580;721;340;298;42;834
20250109;63;351;99;84;15;835
20230109;105;351;277;231;46;836
20230810;580;204;464;274;190;837
20211231;181;837;473;34;439;838
20211112;156;825;280;246;34;839
20230725;442;819;266;141;125;840
20220717;63;818;131;52;79;841
20220817;25;818;382;23;359;842
20220812;741;977;373;112;261;843
20220824;962;721;278;179;99;844
20230819;360;348;106;53;53;845
20230524;634;351;383;206;177;846
20211114;196;876;198;82;116;847
20230921;966;837;268;8;260;848
20250607;955;858;50;16;34;849
20230524;156;354;74;60;14;850
20230512;25;452;380;85;295;851
20230919;966;825;216;62;154;852
20230129;162;720;407;167;240;853
20220410;442;721;458;269;189;854
20220409;955;452;89;85;4;855
20230810;962;351;158;19;139;856
20230831;63;348;472;126;346;857
20230729;597;541;284;128;156;858
20230910;181;286;386;50;336;859
20230829;156;308;257;162;95;860
20220405;580;825;433;9;424;861
20230126;524;286;62;61;1;862
20240205;962;977;474;228;246;863
20240604;294;977;455;287;168;864
20230408;442;837;64;23;41;865
20220804;294;858;443;136;307;866
20220325;741;819;290;55;235;867
20211007;597;720;221;135;86;868
20220505;181;541;364;164;200;869
20211210;634;541;427;422;5;870
20230501;634;286;198;187;11;871
20211206;105;354;456;355;101;872
20230126;524;876;483;281;202;873
20211016;955;308;98;1;97;874
20211031;63;876;413;100;313;875
20211126;156;307;147;28;119;876
20230918;580;647;280;148;132;877
20230422;855;541;203;191;12;878
20230412;181;567;194;135;59;879
20220430;635;721;385;200;185;880
20230702;741;647;486;172;314;881
20230508;962;308;447;64;383;882
20220215;524;818;262;192;70;883
20230203;25;819;393;222;171;884
20230429;524;647;211;48;163;885
20230519;597;567;279;249;30;886
20230412;741;818;122;37;85;887
20230221;162;720;249;39;210;888
20220328;741;351;346;37;309;889
20220708;156;818;384;334;50;890
20230111;442;837;90;70;20;891
20211225;966;567;463;258;205;892
20230215;597;308;464;188;276;893
20230521;580;286;112;10;102;894
20230819;181;204;66;57;9;895
20230812;966;541;459;290;169;896
20220110;955;541;389;232;157;897
20220217;156;541;149;140;9;898
20220402;63;825;142;15;127;899
20230519;63;286;308;139;169;900
20230608;962;351;345;305;40;901
20221004;741;858;374;23;351;902
20220518;580;541;304;173;131;903
20220807;524;819;402;135;267;904
20220530;360;204;131;36;95;905
20230604;962;348;53;45;8;906
20211201;580;837;468;206;262;907
20220801;442;567;65;3;62;908
20230402;966;977;203;103;100;909
20221023;597;452;291;85;206;910
20230212;63;351;78;26;52;911
20220723;580;351;77;23;54;912
20220821;105;721;453;257;196;913
20230206;181;541;72;51;21;914
20230806;196;825;370;241;129;915
20230412;156;307;325;7;318;916
20220216;580;977;265;47;218;917
20221101;63;876;442;237;205;918
20220527;156;348;382;311;71;919
20230125;580;351;452;391;61;920
20221007;156;876;396;230;166;921
20231109;387;452;80;61;19;922
20220422;181;819;358;195;163;923
20220516;855;720;408;328;80;924
20211006;855;647;190;9;181;925
20220912;156;567;255;107;148;926
20211006;156;825;308;189;119;927
20221030;524;977;470;34;436;928
20220723;156;307;377;129;248;929
20220417;181;286;347;99;248;930
20211204;741;541;117;101;16;931
20230205;524;721;202;193;9;932
20230912;442;647;164;159;5;933
20250304;634;354;98;72;26;934
20230712;181;567;136;129;7;935
20220912;162;720;476;162;314;936
20220829;162;308;226;13;213;937
20230626;855;720;266;91;175;938
20220713;156;721;489;53;436;939
20211106;442;541;84;14;70;940
20220309;597;204;138;127;11;941
20210911;105;541;361;303;58;942
20230207;294;541;198;125;73;943
20230323;524;837;367;23;344;944
20220129;63;977;175;97;78;945
20230407;156;452;145;126;19;946
20230513;855;286;459;247;212;947
20220923;741;819;464;48;416;948
20220218;162;351;255;148;107;949
20230408;25;837;395;264;131;950
20220504;156;307;447;52;395;951
20221012;955;819;127;55;72;952
20230223;360;818;275;209;66;953
20230717;962;818;134;127;7;954
20230620;63;819;399;327;72;955
20221222;181;876;195;4;191;956
20220501;442;819;81;76;5;957
20220410;634;541;320;269;51;958
20221113;105;567;494;124;370;959
20210928;635;825;221;74;147;960
20230825;387;825;279;1;278;961
20230709;597;567;141;48;93;962
20220621;360;876;156;54;102;963
20211029;524;818;114;77;37;964
20220101;181;876;331;178;153;965
20230531;387;307;138;30;108;966
20220811;105;567;403;247;156;967
20221023;524;647;81;62;19;968
20230927;634;858;138;33;105;969
20220920;25;351;400;9;391;970
20230331;25;308;112;65;47;971
20220102;63;351;341;199;142;972
20220924;580;819;269;31;238;973
20230610;162;818;387;63;324;974
20230604;63;977;130;128;2;975
20220408;156;351;397;51;346;976
20220719;162;819;366;300;66;977
20220307;196;825;327;103;224;978
20220726;156;837;253;86;167;979
20230726;962;307;106;36;70;980
20221110;105;286;408;246;162;981
20220706;634;825;133;95;38;982
20221012;634;876;286;252;34;983
20220503;196;204;491;327;164;984
20230629;156;825;446;255;191;985
20220525;962;354;459;399;60;986
20220721;196;307;376;265;111;987
20211119;387;721;158;87;71;988
20230603;634;351;285;253;32;989
20211218;962;204;328;95;233;990
20220531;105;307;133;74;59;991
20220726;635;307;491;448;43;992
20230405;360;858;375;295;80;993
20230114;196;307;367;356;11;994
20220811;181;825;53;15;38;995
20240609;105;818;55;19;36;996
20220713;25;286;52;2;50;997
20230403;63;837;329;50;279;998
20220809;580;876;482;19;463;999
20220509;196;308;321;157;164;1000
20230423;524;819;137;21;116;1001
20220510;597;819;67;27;40;1002
20220401;294;720;431;222;209;1003
20230414;105;307;399;45;354;1004
20230124;294;825;474;222;252;1005
20230628;63;977;333;208;125;1006
20230116;524;819;424;162;262;1007
20230509;741;348;122;60;62;1008
20230924;181;351;230;175;55;1009
20221103;156;351;146;47;99;1010
20211216;105;541;121;110;11;1011
20230504;442;354;317;94;223;1012
20220520;162;452;157;128;29;1013
20221213;580;819;91;71;20;1014
20230119;387;307;471;74;397;1015
20220227;634;819;241;110;131;1016
20220731;63;858;257;218;39;1017
20230302;955;348;352;337;15;1018
20220620;966;647;134;30;104;1019
20230728;387;876;60;42;18;1020
20220812;635;837;269;32;237;1021
20220709;741;876;304;181;123;1022
20221010;962;354;91;40;51;1023
20220623;105;825;167;26;141;1024
20220608;294;567;89;27;62;1025
20230310;387;720;50;30;20;1026
20230124;962;351;150;62;88;1027
20231106;105;837;170;107;63;1028
20220512;855;567;336;146;190;1029
20230612;105;876;453;369;84;1030
20220827;63;308;399;47;352;1031
20211108;63;308;407;77;330;1032
20220906;63;819;323;267;56;1033
20230416;634;721;109;4;105;1034
20211224;962;307;253;103;150;1035
20240310;63;720;481;128;353;1036
20230728;966;348;380;377;3;1037
20230214;634;977;207;143;64;1038
20230521;360;348;68;19;49;1039
20230120;196;818;337;192;145;1040
20231005;387;858;402;65;337;1041
20230103;181;876;270;100;170;1042
20230705;181;308;425;341;84;1043
20211030;580;307;492;167;325;1044
20221101;442;354;72;54;18;1045
20211024;162;819;106;62;44;1046
20211104;966;204;65;51;14;1047
20240612;580;818;188;92;96;1048
20211207;966;837;401;278;123;1049
20221008;962;541;473;429;44;1050
20211018;181;351;370;176;194;1051
20220926;962;541;348;64;284;1052
20221208;181;567;215;133;82;1053
20230525;634;452;295;150;145;1054
20220209;634;351;86;76;10;1055
20211210;635;351;462;431;31;1056
20230303;962;348;188;160;28;1057
20220414;635;819;223;48;175;1058
20220711;156;354;75;33;42;1059
20230409;294;354;243;41;202;1060
20220410;580;567;232;64;168;1061
20230408;105;204;298;283;15;1062
20230130;105;818;194;183;11;1063
20220128;181;720;339;164;175;1064
20221105;442;647;441;12;429;1065
20220609;580;876;112;45;67;1066
20230115;442;647;422;211;211;1067
20230503;635;541;140;19;121;1068
20211009;955;541;239;63;176;1069
20230701;524;977;287;272;15;1070
20230808;855;818;145;89;56;1071
20220104;196;354;137;18;119;1072
20221105;955;721;495;335;160;1073
20220911;634;825;132;105;27;1074
20221028;580;348;225;214;11;1075
20230928;855;876;500;116;384;1076
20230916;294;567;472;11;461;1077
20230925;387;819;230;21;209;1078
20211130;181;308;258;107;151;1079
20220324;360;858;307;306;1;1080
20221104;156;204;210;198;12;1081
20211030;196;825;486;221;265;1082
20230517;196;977;101;86;15;1083
20230206;580;977;390;374;16;1084
20211121;156;825;75;24;51;1085
20230810;855;818;232;189;43;1086
20230809;25;452;404;80;324;1087
20220502;442;348;184;72;112;1088
20230426;597;819;373;199;174;1089
20230916;966;837;391;100;291;1090
20220930;955;567;145;63;82;1091
20220313;741;348;430;324;106;1092
20230218;855;977;297;155;142;1093
20230123;387;308;422;73;349;1094
20231202;294;837;116;64;52;1095
20230525;387;452;342;227;115;1096
20220531;634;876;387;386;1;1097
20230703;105;858;426;289;137;1098
20230423;966;819;216;135;81;1099
20250104;962;541;141;15;126;1100
20220818;162;452;287;30;257;1101
20220913;360;818;91;80;11;1102
20221102;442;351;212;45;167;1103
20230622;966;721;382;58;324;1104
20211003;580;541;127;107;20;1105
20221016;63;351;227;120;107;1106
20221017;741;818;97;28;69;1107
20220413;105;351;96;39;57;1108
20211003;955;348;221;217;4;1109
20221117;105;541;460;171;289;1110
20220809;962;837;405;314;91;1111
20230208;580;452;322;106;216;1112
20230518;580;858;324;173;151;1113
20230827;63;307;307;90;217;1114
20221128;634;354;407;330;77;1115
20221218;63;286;236;76;160;1116
20220102;597;307;369;54;315;1117
20211119;855;204;290;241;49;1118
20220428;294;825;74;40;34;1119
20211119;580;307;147;133;14;1120
20230901;25;721;139;45;94;1121
20230720;580;825;146;40;106;1122
20230501;580;858;243;124;119;1123
20211230;162;837;464;115;349;1124
20211002;634;977;61;44;17;1125
20230630;156;825;157;149;8;1126
20220704;580;720;203;44;159;1127
20230525;162;819;443;104;339;1128
20230403;580;286;174;74;100;1129
20211212;63;977;322;24;298;1130
20220806;855;567;203;37;166;1131
20220411;25;286;234;5;229;1132
20221122;855;567;51;17;34;1133
20230410;597;567;351;194;157;1134
20211007;966;720;187;36;151;1135
20220518;580;819;208;21;187;1136
20220122;25;351;147;77;70;1137
20230911;63;348;134;128;6;1138
20230218;855;721;258;76;182;1139
20230303;597;720;100;84;16;1140
20221212;741;819;414;337;77;1141
20230625;181;837;470;98;372;1142
20211009;442;977;281;186;95;1143
20230417;442;204;165;118;47;1144
20220515;524;977;205;23;182;1145
20230104;25;825;74;60;14;1146
20220731;966;876;120;13;107;1147
20220406;855;541;70;38;32;1148
20220318;105;351;391;314;77;1149
20230421;360;308;431;69;362;1150
20250309;855;720;284;233;51;1151
20211224;162;348;500;358;142;1152
20220106;105;876;411;209;202;1153
20220927;580;977;263;206;57;1154
20230810;524;819;64;33;31;1155
20211111;962;204;164;78;86;1156
20230826;387;204;492;391;101;1157
20220107;962;348;319;234;85;1158
20220518;855;858;337;9;328;1159
20230619;741;647;191;135;56;1160
20220827;105;286;232;175;57;1161
20220117;25;819;105;50;55;1162
20230913;955;819;399;124;275;1163
20230420;635;837;439;244;195;1164
20221129;580;818;98;69;29;1165
20220104;25;876;489;416;73;1166
20211125;955;308;453;85;368;1167
20230108;294;351;475;113;362;1168
20240109;181;354;293;258;35;1169
20211027;635;307;475;38;437;1170
20230803;181;858;104;66;38;1171
20220724;580;567;484;225;259;1172
20211109;25;307;232;195;37;1173
20230120;294;825;347;179;168;1174
20220505;442;825;444;360;84;1175
20220109;962;819;425;415;10;1176
20230131;855;286;299;242;57;1177
20220318;25;720;193;99;94;1178
20220319;634;307;304;16;288;1179
20221120;25;354;385;82;303;1180
20230131;966;819;185;162;23;1181
20230909;524;825;406;288;118;1182
20230612;962;307;203;75;128;1183
20221027;63;647;198;68;130;1184
20240207;162;354;412;292;120;1185
20230519;741;452;125;27;98;1186
20220626;524;286;119;106;13;1187
20220214;181;351;377;72;305;1188
20220103;524;307;236;105;131;1189
20230816;442;308;92;49;43;1190
20230415;196;452;454;16;438;1191
20230703;962;308;247;187;60;1192
20220521;741;721;270;151;119;1193
20230728;156;858;135;47;88;1194
20220217;442;204;353;26;327;1195
20240606;156;286;307;273;34;1196
20230522;387;825;88;3;85;1197
20220821;597;541;278;217;61;1198
20230323;25;647;95;60;35;1199
20211013;597;307;222;7;215;1200
20220423;162;204;397;304;93;1201
20230226;360;286;72;57;15;1202
20211216;966;452;413;358;55;1203
20230613;597;541;142;92;50;1204
20220421;597;452;204;200;4;1205
20230227;105;825;252;139;113;1206
20210910;580;858;93;12;81;1207
20230911;162;647;313;47;266;1208
20220529;360;720;288;247;41;1209
20211020;196;354;54;34;20;1210
20220803;181;818;409;47;362;1211
20230807;162;567;498;334;164;1212
20230615;635;567;490;258;232;1213
20220929;156;858;281;88;193;1214
20221206;196;825;485;68;417;1215
20220414;294;307;77;16;61;1216
20220823;63;818;54;21;33;1217
20230123;962;204;219;49;170;1218
20221218;63;567;493;259;234;1219
20230418;966;720;209;179;30;1220
20221110;741;354;285;31;254;1221
20230118;855;351;339;102;237;1222
20211111;635;721;337;56;281;1223
20220107;156;307;407;251;156;1224
20220514;196;286;494;385;109;1225
20230721;962;825;61;55;6;1226
20230916;387;837;347;167;180;1227
20221023;156;876;284;228;56;1228
20220918;360;977;246;233;13;1229
20221201;524;286;109;57;52;1230
20220820;162;876;153;13;140;1231
20230917;105;307;59;2;57;1232
20230622;63;348;481;56;425;1233
20230725;181;286;85;27;58;1234
20220714;294;541;449;42;407;1235
20220211;63;977;339;164;175;1236
20240404;634;876;300;284;16;1237
20240403;105;647;111;38;73;1238
20230826;156;452;389;330;59;1239
20230607;955;308;197;111;86;1240
20220503;360;307;113;78;35;1241
20211112;966;452;89;61;28;1242
20220201;855;858;496;494;2;1243
20220712;966;858;168;97;71;1244
20221220;962;541;318;126;192;1245
20220904;105;818;411;401;10;1246
20220126;294;351;192;103;89;1247
20211130;966;204;170;62;108;1248
20241008;105;354;133;7;126;1249
20220708;597;541;427;361;66;1250
20211026;181;819;407;93;314;1251
20220404;387;720;469;63;406;1252
20220326;294;819;87;1;86;1253
20230309;196;876;203;14;189;1254
20220409;442;204;461;162;299;1255
20230323;105;825;177;138;39;1256
20220104;105;876;317;23;294;1257
20221106;634;567;391;171;220;1258
20230326;63;837;270;230;40;1259
20220329;955;351;311;243;68;1260
20220120;580;647;441;246;195;1261
20230912;955;204;131;121;10;1262
20221026;156;825;307;64;243;1263
20211031;634;818;429;310;119;1264
20240905;955;825;135;81;54;1265
20230828;196;286;141;61;80;1266
20211208;524;204;73;52;21;1267
20230210;162;348;89;27;62;1268
20230806;181;567;307;299;8;1269
20220316;955;721;492;378;114;1270
20220602;442;307;264;123;141;1271
20220123;442;818;330;231;99;1272
20220509;294;308;236;135;101;1273
20220804;162;858;349;45;304;1274
20230419;105;818;307;126;181;1275
20220628;181;307;116;38;78;1276
20220619;524;721;139;94;45;1277
20220731;966;567;304;269;35;1278
20230727;955;818;457;25;432;1279
20221011;442;286;423;201;222;1280
20220329;162;876;318;130;188;1281
20220428;442;204;472;6;466;1282
20240807;105;977;326;47;279;1283
20221029;294;977;474;413;61;1284
20211222;966;647;474;317;157;1285
20230120;635;819;497;248;249;1286
20230607;360;204;483;414;69;1287
20230921;962;567;318;2;316;1288
20211002;156;452;121;21;100;1289
20230104;524;204;473;345;128;1290
20240305;294;348;255;149;106;1291
20230611;741;819;105;9;96;1292
20230503;855;567;492;344;148;1293
20230913;25;720;374;250;124;1294
20221122;855;351;159;29;130;1295
20230128;597;837;137;28;109;1296
20211022;63;308;455;204;251;1297
20230806;962;647;465;270;195;1298
20210110;580;354;114;102;12;1299
20221222;294;204;384;117;267;1300
20211003;63;818;494;483;11;1301
20211227;524;819;146;74;72;1302
20220414;181;452;490;313;177;1303
20230711;25;452;213;211;2;1304
20230603;181;647;417;61;356;1305
20220517;156;567;477;401;76;1306
20220616;25;977;258;139;119;1307
20211205;597;286;406;48;358;1308
20230603;63;647;310;7;303;1309
20220202;962;567;398;159;239;1310
20220204;966;204;160;72;88;1311
20230520;63;351;484;167;317;1312
20220920;580;818;430;384;46;1313
20220907;105;541;179;57;122;1314
20220519;580;204;106;76;30;1315
20230614;580;977;332;238;94;1316
20230423;635;204;190;172;18;1317
20220511;597;351;290;98;192;1318
20240609;855;567;281;269;12;1319
20220415;63;307;364;88;276;1320
20221007;962;825;340;40;300;1321
20230122;63;819;107;26;81;1322
20230328;524;647;323;323;0;1323
20221126;962;286;250;62;188;1324
20211009;156;837;323;288;35;1325
20230226;634;977;238;15;223;1326
20230505;966;720;323;289;34;1327
20221219;181;452;241;210;31;1328
20230201;387;348;385;29;356;1329
20221230;966;647;53;1;52;1330
20230326;966;354;132;108;24;1331
20220214;855;977;429;337;92;1332
20220421;181;818;178;151;27;1333
20211205;962;567;221;77;144;1334
20230908;63;858;347;32;315;1335
20230630;634;818;271;124;147;1336
20220306;25;647;98;22;76;1337
20211217;105;818;289;123;166;1338
20230623;360;837;111;39;72;1339
20221021;580;354;248;215;33;1340
20220105;442;837;77;20;57;1341
20241002;181;858;496;282;214;1342
20221123;442;818;232;80;152;1343
20220627;741;647;124;46;78;1344
20230404;294;567;373;139;234;1345
20230118;181;354;105;90;15;1346
20230619;855;876;272;206;66;1347
20220629;635;858;214;33;181;1348
20240108;162;647;298;48;250;1349
20211024;635;858;96;87;9;1350
20230407;635;308;193;148;45;1351
20220102;196;720;222;65;157;1352
20221109;63;819;153;87;66;1353
20220801;442;977;281;116;165;1354
20220503;25;351;435;429;6;1355
20221118;524;351;111;88;23;1356
20230108;156;721;230;190;40;1357
20230926;181;541;274;24;250;1358
20220113;955;452;383;339;44;1359
20230822;597;720;262;120;142;1360
20211108;855;354;260;2;258;1361
20230517;105;204;215;158;57;1362
20221017;524;541;336;169;167;1363
20220117;580;721;231;71;160;1364
20230409;634;825;283;13;270;1365
20211222;741;720;350;338;12;1366
20221202;162;204;341;273;68;1367
20220630;162;818;347;112;235;1368
20220302;962;837;269;214;55;1369
20230317;524;351;267;215;52;1370
20230309;741;354;191;176;15;1371
20221217;741;721;447;175;272;1372
20221106;966;825;438;156;282;1373
20230502;597;452;118;65;53;1374
20221204;294;541;248;243;5;1375
20230330;294;354;111;6;105;1376
20211004;196;354;111;101;10;1377
20231109;294;858;310;84;226;1378
20230603;63;721;412;225;187;1379
20250705;360;977;281;152;129;1380
20230604;580;977;458;101;357;1381
20230407;387;308;419;261;158;1382
20211030;63;977;359;193;166;1383
20230402;855;721;153;134;19;1384
20220601;955;286;391;66;325;1385
20220210;580;204;319;286;33;1386
20230927;196;858;166;16;150;1387
20230405;156;307;453;109;344;1388
20230225;741;977;143;10;133;1389
20220920;63;307;326;183;143;1390
20220603;597;351;493;493;0;1391
20220223;634;307;422;111;311;1392
20220210;63;818;433;355;78;1393
20220306;741;720;198;63;135;1394
20220622;105;286;312;219;93;1395
20221002;156;825;441;3;438;1396
20221105;442;819;100;67;33;1397
20230211;387;204;491;452;39;1398
20221003;597;837;472;175;297;1399
20230405;156;721;381;301;80;1400
20220124;442;307;200;24;176;1401
20220422;635;351;123;96;27;1402
20220318;387;541;238;82;156;1403
20211025;597;452;248;41;207;1404
20211027;63;858;454;134;320;1405
20230525;955;351;417;111;306;1406
20220517;855;876;117;60;57;1407
20220506;105;204;447;155;292;1408
20220315;524;348;394;302;92;1409
20220916;635;818;480;133;347;1410
20220305;962;541;160;115;45;1411
20221106;387;286;484;466;18;1412
20230626;196;452;378;272;106;1413
20211101;162;351;301;243;58;1414
20220507;63;204;230;31;199;1415
20220328;196;567;500;111;389;1416
20221023;524;308;301;229;72;1417
20230207;162;819;464;388;76;1418
20230922;25;977;306;150;156;1419
20230925;634;858;168;148;20;1420
20230505;162;819;379;171;208;1421
20230802;387;354;197;57;140;1422
20220812;162;720;113;66;47;1423
20220627;962;308;90;6;84;1424
20230526;387;818;121;52;69;1425
20230422;597;204;175;85;90;1426
20220701;962;720;167;126;41;1427
20230227;442;567;343;153;190;1428
20221125;25;721;395;98;297;1429
20230908;63;204;290;179;111;1430
20220930;634;286;394;191;203;1431
20230906;635;837;325;15;310;1432
20230109;524;977;469;370;99;1433
20230304;580;647;252;240;12;1434
20230914;181;452;399;36;363;1435
20220921;442;354;88;39;49;1436
20230623;105;858;180;100;80;1437
20220211;25;819;167;50;117;1438
20211206;156;837;260;245;15;1439
20211202;156;876;231;135;96;1440
20220512;25;977;159;118;41;1441
20220817;524;819;128;123;5;1442
20221103;597;720;405;183;222;1443
20230514;196;977;288;215;73;1444
20221210;855;858;176;67;109;1445
20220222;162;351;403;191;212;1446
20250208;966;721;229;13;216;1447
20220816;360;452;452;242;210;1448
20220908;962;977;397;183;214;1449
20230207;442;647;297;146;151;1450
20230801;294;876;131;5;126;1451
20221119;962;308;259;140;119;1452
20220711;360;825;322;132;190;1453
20221217;63;837;223;202;21;1454
20220205;855;858;58;28;30;1455
20230609;442;354;203;99;104;1456
20230223;181;286;441;97;344;1457
20221004;597;721;454;243;211;1458
20220607;196;858;279;240;39;1459
20230917;741;286;170;64;106;1460
20230425;196;858;356;80;276;1461
20220916;966;818;61;44;17;1462
20220813;387;567;496;330;166;1463
20230228;25;541;268;123;145;1464
20230127;196;308;113;75;38;1465
20230416;635;452;409;196;213;1466
20211222;63;858;427;95;332;1467
20230808;966;858;149;143;6;1468
20211221;181;541;86;15;71;1469
20230119;962;348;229;135;94;1470
20230310;25;647;288;128;160;1471
20220406;966;977;145;51;94;1472
20250307;855;348;346;45;301;1473
20220907;635;858;432;64;368;1474
20221230;25;721;151;97;54;1475
20230408;635;818;385;77;308;1476
20221218;634;307;266;58;208;1477
20220907;855;204;427;98;329;1478
20211110;196;567;200;150;50;1479
20211127;63;825;107;78;29;1480
20211219;966;308;365;15;350;1481
20221024;63;204;232;65;167;1482
20220823;162;308;74;66;8;1483
20230712;63;204;210;170;40;1484
20211002;162;818;288;54;234;1485
20220209;580;308;158;130;28;1486
20240303;63;819;279;252;27;1487
20220902;63;818;51;45;6;1488
20230917;966;286;222;66;156;1489
20220212;524;647;161;132;29;1490
20220929;855;819;404;128;276;1491
20230301;387;720;136;38;98;1492
20220914;63;567;357;150;207;1493
20230618;63;837;332;99;233;1494
20240201;156;837;447;441;6;1495
20230428;156;308;300;3;297;1496
20220403;162;721;57;5;52;1497
20221214;524;819;260;248;12;1498
20211022;962;825;488;198;290;1499
20220730;162;541;226;120;106;1500
20220604;63;858;336;160;176;1501
20221203;962;876;436;427;9;1502
20230310;156;348;89;89;0;1503
20220113;442;858;236;132;104;1504
20220406;855;858;234;185;49;1505
20221109;966;308;453;380;73;1506
20221011;63;818;436;317;119;1507
20220330;855;858;289;68;221;1508
20220317;196;567;214;55;159;1509
20220103;162;348;281;102;179;1510
20220122;360;721;483;450;33;1511
20230803;387;351;447;5;442;1512
20231203;966;452;180;115;65;1513
20220215;955;720;118;65;53;1514
20230725;63;452;85;37;48;1515
20230728;63;308;310;177;133;1516
20211121;966;307;214;199;15;1517
20221108;741;308;225;206;19;1518
20211220;634;818;89;64;25;1519
20230918;580;837;398;97;301;1520
20230122;63;876;185;169;16;1521
20211216;156;286;371;36;335;1522
20230125;524;452;98;20;78;1523
20230403;63;858;75;60;15;1524
20221105;635;351;143;50;93;1525
20230904;181;837;275;202;73;1526
20220112;360;818;322;187;135;1527
20221204;855;858;349;187;162;1528
20230222;181;354;299;36;263;1529
20230718;294;858;347;223;124;1530
20220206;25;819;132;29;103;1531
20230420;25;721;214;124;90;1532
20230414;955;977;322;37;285;1533
20230225;955;876;196;19;177;1534
20230919;442;825;271;127;144;1535
20220923;156;452;383;331;52;1536
20220513;966;647;347;249;98;1537
20230325;580;647;455;105;350;1538
20230601;162;977;402;340;62;1539
20230625;156;818;263;168;95;1540
20220113;162;647;115;32;83;1541
20211116;25;354;481;112;369;1542
20230129;962;307;346;189;157;1543
20230313;25;858;363;172;191;1544
20230627;360;721;69;32;37;1545
20230601;597;720;282;191;91;1546
20220814;63;351;57;56;1;1547
20220314;634;819;106;62;44;1548
20240509;196;354;369;191;178;1549
20211222;387;567;143;82;61;1550
20220728;196;825;143;17;126;1551
20221015;105;818;293;159;134;1552
20220808;741;541;373;259;114;1553
20230926;360;819;238;160;78;1554
20220612;597;819;59;46;13;1555
20220115;25;308;117;20;97;1556
20211125;294;541;464;215;249;1557
20220722;635;647;413;194;219;1558
20221212;580;977;140;3;137;1559
20230514;634;721;103;101;2;1560
20221102;105;977;174;155;19;1561
20220509;524;354;112;11;101;1562
20220316;25;819;305;288;17;1563
20220820;294;825;436;40;396;1564
20220728;105;819;321;317;4;1565
20211208;63;286;422;357;65;1566
20220126;105;837;71;36;35;1567
20230809;955;858;479;83;396;1568
20220510;63;977;367;25;342;1569
20211215;294;354;377;222;155;1570
20220823;196;647;135;17;118;1571
20230604;196;567;341;11;330;1572
20230202;105;567;213;108;105;1573
20220329;294;825;80;38;42;1574
20221207;741;204;143;103;40;1575
20230308;597;204;268;243;25;1576
20220901;635;351;226;178;48;1577
20210930;25;647;79;35;44;1578
20240403;196;541;182;155;27;1579
20220728;181;348;388;222;166;1580
20230611;25;204;496;458;38;1581
20241004;156;204;259;254;5;1582
20230912;597;721;84;51;33;1583
20220729;597;825;357;292;65;1584
20220413;524;721;319;64;255;1585
20230105;294;541;349;315;34;1586
20230809;196;721;357;117;240;1587
20220929;162;354;207;150;57;1588
20221213;597;819;258;159;99;1589
20230421;597;721;431;303;128;1590
20231009;294;204;228;172;56;1591
20230111;580;452;75;22;53;1592
20220116;855;307;316;160;156;1593
20210111;360;720;446;27;419;1594
20220323;63;452;86;19;67;1595
20230619;63;354;60;34;26;1596
20230310;966;348;273;163;110;1597
20230819;360;452;401;198;203;1598
20230806;360;286;330;190;140;1599
20220604;855;348;171;123;48;1600
20220518;162;286;322;14;308;1601
20220602;635;819;397;203;194;1602
20220503;597;541;79;64;15;1603
20230726;855;541;415;77;338;1604
20240706;524;286;100;87;13;1605
20230207;63;567;102;15;87;1606
20230523;105;307;336;36;300;1607
20211220;635;452;337;283;54;1608
20220911;966;567;80;18;62;1609
20220921;524;819;79;76;3;1610
20211220;962;977;279;207;72;1611
20230312;955;720;150;61;89;1612
20220422;962;308;60;20;40;1613
20221129;855;721;103;87;16;1614
20220909;181;567;464;26;438;1615
20230212;741;858;132;26;106;1616
20220112;524;452;327;6;321;1617
20220126;294;567;357;51;306;1618
20230204;162;204;248;139;109;1619
20221230;442;721;321;242;79;1620
20220830;105;541;112;16;96;1621
20230208;634;977;88;20;68;1622
20230504;360;452;127;125;2;1623
20230529;966;286;489;169;320;1624
20230814;442;348;90;24;66;1625
20221025;196;818;432;234;198;1626
20230408;294;351;341;185;156;1627
20211028;634;825;295;172;123;1628
20230815;63;647;308;165;143;1629
20230121;63;858;345;27;318;1630
20220501;524;876;353;236;117;1631
20240406;442;977;411;404;7;1632
20220429;597;858;158;101;57;1633
20220810;181;351;352;183;169;1634
20230828;387;876;219;123;96;1635
20220213;597;452;193;10;183;1636
20221128;162;858;135;12;123;1637
20211231;156;818;193;86;107;1638
20211224;25;819;158;130;28;1639
20211207;580;204;424;229;195;1640
20211020;294;286;197;52;145;1641
20211013;387;567;445;87;358;1642
20220905;635;351;272;120;152;1643
20230912;387;452;88;73;15;1644
20230111;635;204;322;234;88;1645
20230729;524;876;369;196;173;1646
20230921;181;825;366;14;352;1647
20211221;196;647;413;249;164;1648
20220413;63;354;84;49;35;1649
20230708;442;858;348;244;104;1650
20230808;442;452;205;118;87;1651
20221221;181;307;327;27;300;1652
20220910;597;819;407;362;45;1653
20230829;741;452;228;186;42;1654
20230902;966;567;130;99;31;1655
20211118;196;452;354;108;246;1656
20230204;360;825;174;105;69;1657
20220120;156;204;341;305;36;1658
20211015;156;307;196;81;115;1659
20220710;196;348;414;278;136;1660
20221231;63;354;110;30;80;1661
20230924;524;876;364;270;94;1662
20221211;955;567;456;147;309;1663
20220218;741;858;57;46;11;1664
20230112;955;286;395;356;39;1665
20230408;524;567;258;141;117;1666
20211223;524;308;454;385;69;1667
20220616;105;647;436;410;26;1668
20230705;105;307;206;125;81;1669
20230806;955;876;111;37;74;1670
20230902;196;720;197;109;88;1671
20230721;524;354;479;13;466;1672
20220704;741;204;275;275;0;1673
20221126;181;720;68;18;50;1674
20230125;855;819;212;75;137;1675
20211029;855;286;410;277;133;1676
20220530;635;825;435;288;147;1677
20211125;955;452;355;225;130;1678
20230801;855;647;406;333;73;1679
20211115;855;819;165;137;28;1680
20230805;105;348;432;408;24;1681
20230912;855;354;108;10;98;1682
20221223;442;818;454;389;65;1683
20220320;156;452;124;47;77;1684
20230416;955;977;149;50;99;1685
20220503;597;307;99;77;22;1686
20230818;25;720;310;281;29;1687
20220407;962;354;347;293;54;1688
20221207;524;567;294;148;146;1689
20220214;294;977;474;235;239;1690
20220201;634;286;313;151;162;1691
20211029;966;286;79;60;19;1692
20220515;162;837;60;50;10;1693
20230519;955;876;408;276;132;1694
20230402;387;721;173;19;154;1695
20231107;63;541;337;73;264;1696
20230310;442;541;236;216;20;1697
20230515;524;348;196;107;89;1698
20220523;966;354;480;463;17;1699
20220913;63;286;192;166;26;1700
20211013;966;720;412;303;109;1701
20230826;962;825;178;154;24;1702
20221108;105;858;447;27;420;1703
20220126;387;354;471;423;48;1704
20220613;524;721;428;394;34;1705
20230829;580;819;62;31;31;1706
20220310;741;348;229;202;27;1707
20221117;635;720;75;5;70;1708
20230307;387;647;315;231;84;1709
20231203;162;286;405;395;10;1710
20220525;156;541;286;107;179;1711
20230920;580;647;126;57;69;1712
20230924;524;567;270;241;29;1713
20230115;294;286;262;228;34;1714
20220811;962;348;366;112;254;1715
20230413;962;567;145;35;110;1716
20230512;196;204;342;294;48;1717
20220502;955;837;202;59;143;1718
20220212;524;541;343;84;259;1719
20220307;855;818;120;24;96;1720
20220820;25;818;326;299;27;1721
20231111;360;720;184;29;155;1722
20230629;196;567;121;64;57;1723
20220222;597;818;395;302;93;1724
20221111;442;837;490;66;424;1725
20230608;181;819;91;59;32;1726
20211021;634;567;440;439;1;1727
20230125;387;977;66;24;42;1728
20230227;634;452;354;241;113;1729
20230131;294;348;100;68;32;1730
20220928;156;825;493;60;433;1731
20230416;294;720;381;176;205;1732
20230831;196;977;232;52;180;1733
20221111;634;567;427;114;313;1734
20221129;855;720;321;99;222;1735
20230812;966;308;367;266;101;1736
20231004;105;818;54;18;36;1737
20230131;181;567;399;103;296;1738
20230908;524;819;468;439;29;1739
20230906;196;286;302;55;247;1740
20230516;25;567;286;273;13;1741
20230507;955;647;449;341;108;1742
20230206;442;720;67;52;15;1743
20230817;635;308;92;33;59;1744
20230108;387;567;440;113;327;1745
20221210;294;825;484;152;332;1746
20220507;63;307;441;289;152;1747
20220510;294;858;383;44;339;1748
20230928;597;825;289;187;102;1749
20220514;63;837;367;218;149;1750
20230402;63;721;347;284;63;1751
20240108;63;819;479;473;6;1752
20210312;580;567;282;195;87;1753
20220428;105;307;349;220;129;1754
20220629;63;858;477;403;74;1755
20211104;181;825;456;218;238;1756
20220624;105;647;122;121;1;1757
20230920;580;977;394;58;336;1758
20220817;634;308;51;39;12;1759
20220709;360;858;361;73;288;1760
20230114;524;204;150;107;43;1761
20220905;181;876;460;424;36;1762
20221212;580;348;267;53;214;1763
20220425;962;567;346;203;143;1764
20220309;855;307;145;79;66;1765
20230111;442;837;186;81;105;1766
20220815;635;348;105;69;36;1767
20230301;597;354;102;32;70;1768
20230707;741;452;282;10;272;1769
20220929;387;354;214;148;66;1770
20230607;442;354;398;90;308;1771
20221106;962;204;302;210;92;1772
20220421;63;286;150;59;91;1773
20231001;162;308;312;263;49;1774
20220410;63;720;431;23;408;1775
20211222;196;818;268;75;193;1776
20230319;962;818;274;211;63;1777
20230117;962;876;51;24;27;1778
20230630;162;452;372;366;6;1779
20220803;360;286;296;292;4;1780
20220607;105;837;115;42;73;1781
20220402;181;819;181;128;53;1782
20211028;580;858;445;147;298;1783
20221108;387;818;289;109;180;1784
20220618;162;541;410;118;292;1785
20240303;955;348;226;85;141;1786
20211014;63;286;169;165;4;1787
20220114;360;541;223;208;15;1788
20220417;63;541;446;193;253;1789
20220211;955;977;434;326;108;1790
20240408;156;721;429;19;410;1791
20220930;387;348;278;274;4;1792
20211124;63;977;253;85;168;1793
20230125;955;647;50;2;48;1794
20230708;156;819;152;145;7;1795
20220510;294;204;154;138;16;1796
20220509;855;721;481;284;197;1797
20211114;105;452;247;223;24;1798
20230502;741;286;105;26;79;1799
20220927;156;837;368;8;360;1800
20220311;387;825;341;2;339;1801
20220215;63;977;197;123;74;1802
20230309;387;541;228;94;134;1803
20230402;294;348;337;3;334;1804
20230724;156;721;424;208;216;1805
20230829;855;721;177;156;21;1806
20220908;196;354;400;148;252;1807
20220526;855;286;383;315;68;1808
20231208;196;307;201;68;133;1809
20230528;63;837;396;224;172;1810
20230908;962;876;500;386;114;1811
20220414;25;204;177;94;83;1812
20230524;855;541;214;70;144;1813
20220509;105;541;219;86;133;1814
20220712;294;541;162;152;10;1815
20220904;442;876;281;260;21;1816
20220904;25;308;181;51;130;1817
20220219;442;825;160;13;147;1818
20230527;741;720;83;10;73;1819
20221211;156;348;110;81;29;1820
20230907;105;308;423;354;69;1821
20230209;966;452;205;88;117;1822
20211112;181;825;139;75;64;1823
20230701;597;720;216;17;199;1824
20211210;955;354;318;169;149;1825
20220614;387;351;432;225;207;1826
20211013;955;351;235;173;62;1827
20230721;196;308;109;84;25;1828
20220207;294;307;119;23;96;1829
20230529;196;721;328;39;289;1830
20220915;387;567;354;206;148;1831
20230702;360;876;417;316;101;1832
20220919;162;308;337;151;186;1833
20230315;855;354;291;172;119;1834
20220527;181;286;496;44;452;1835
20230525;524;541;395;336;59;1836
20211026;196;308;122;42;80;1837
20211110;962;567;499;383;116;1838
20230214;634;286;143;132;11;1839
20220313;597;837;62;38;24;1840
20230129;741;647;244;197;47;1841
20240904;442;541;303;95;208;1842
20230926;162;351;265;77;188;1843
20230324;181;818;451;308;143;1844
20230110;597;567;496;466;30;1845
20230121;741;825;110;31;79;1846
20220801;635;825;300;279;21;1847
20211019;360;825;361;150;211;1848
20230217;634;348;112;43;69;1849
20230331;63;825;74;72;2;1850
20221007;741;204;320;299;21;1851
20230512;181;720;172;136;36;1852
20220620;387;204;366;316;50;1853
20220722;966;348;162;73;89;1854
20220507;597;647;121;60;61;1855
20221028;635;351;430;103;327;1856
20230418;63;819;158;87;71;1857
20221206;162;858;433;22;411;1858
20220423;156;720;294;23;271;1859
20221027;634;825;495;332;163;1860
20211218;634;876;500;440;60;1861
20230416;63;286;198;94;104;1862
20230822;966;819;207;25;182;1863
20230406;181;819;167;57;110;1864
20230607;105;876;74;38;36;1865
20230613;635;204;200;17;183;1866
20230401;634;818;73;28;45;1867
20221017;635;647;431;233;198;1868
20220805;966;721;418;216;202;1869
20230715;294;351;473;133;340;1870
20220927;955;286;403;298;105;1871
20240408;181;348;394;234;160;1872
20220805;524;307;379;299;80;1873
20220522;634;825;178;48;130;1874
20220223;181;351;133;39;94;1875
20220201;25;876;407;274;133;1876
20230923;63;818;355;129;226;1877
20230917;63;351;302;202;100;1878
20220620;580;348;497;252;245;1879
20230518;966;307;187;185;2;1880
20220505;360;818;168;150;18;1881
20230611;955;876;337;211;126;1882
20220826;966;837;429;206;223;1883
20230813;25;647;366;162;204;1884
20221207;196;204;101;85;16;1885
20211129;524;977;209;177;32;1886
20230629;524;452;412;396;16;1887
20220811;442;348;302;148;154;1888
20211222;635;819;482;332;150;1889
20230114;962;204;256;91;165;1890
20230913;955;818;441;367;74;1891
20220101;966;286;172;124;48;1892
20221107;63;354;324;56;268;1893
20221020;196;308;89;89;0;1894
20220708;741;721;299;105;194;1895
20231103;162;308;446;60;386;1896
20220506;360;647;258;1;257;1897
20230220;105;286;182;66;116;1898
20220429;580;858;428;138;290;1899
20230904;156;286;380;333;47;1900
20211220;966;720;86;17;69;1901
20230307;196;825;190;93;97;1902
20220211;25;452;392;233;159;1903
20230310;105;977;271;175;96;1904
20220201;962;818;132;118;14;1905
20230103;962;858;176;29;147;1906
20210512;181;720;187;34;153;1907
20220731;597;307;97;96;1;1908
20221231;63;286;89;8;81;1909
20221117;966;351;110;48;62;1910
20230116;196;819;461;123;338;1911
20211020;741;721;326;49;277;1912
20220808;196;977;465;163;302;1913
20230508;294;308;311;273;38;1914
20230706;156;204;392;128;264;1915
20230411;962;721;366;128;238;1916
20230722;966;819;187;159;28;1917
20220411;105;286;121;22;99;1918
20220802;294;876;292;60;232;1919
20220523;63;720;385;79;306;1920
20230125;741;348;483;402;81;1921
20211203;580;818;271;33;238;1922
20230206;634;308;290;71;219;1923
20230911;580;819;280;259;21;1924
20240703;442;307;328;42;286;1925
20221206;442;818;100;16;84;1926
20220412;360;825;399;167;232;1927
20231205;63;720;225;194;31;1928
20230111;294;876;436;377;59;1929
20221109;196;204;394;18;376;1930
20220426;442;977;244;27;217;1931
20230928;63;825;220;43;177;1932
20221211;955;307;166;87;79;1933
20230101;524;977;171;19;152;1934
20230326;162;858;279;190;89;1935
20220426;63;307;181;70;111;1936
20221229;387;858;221;167;54;1937
20220328;25;452;491;124;367;1938
20220222;63;286;60;6;54;1939
20220619;955;308;109;31;78;1940
20221104;25;354;420;242;178;1941
20230117;25;351;374;54;320;1942
20230407;25;351;142;33;109;1943
20230107;156;720;435;378;57;1944
20211104;966;204;317;89;228;1945
20230227;105;721;240;228;12;1946
20230927;442;721;242;48;194;1947
20211019;966;354;293;174;119;1948
20211110;360;647;51;25;26;1949
20220430;855;452;225;7;218;1950
20220914;25;647;363;20;343;1951
20220630;597;351;216;140;76;1952
20240312;580;819;67;33;34;1953
20211107;597;720;225;91;134;1954
20230803;580;977;92;22;70;1955
20211129;105;818;349;325;24;1956
20230313;966;452;457;181;276;1957
20230601;25;858;373;115;258;1958
20220314;181;837;80;8;72;1959
20220728;181;541;193;98;95;1960
20211204;387;307;462;199;263;1961
20221207;25;720;285;123;162;1962
20221215;156;858;394;15;379;1963
20220330;580;351;190;134;56;1964
20211230;635;858;295;219;76;1965
20221214;63;204;436;311;125;1966
20231009;181;977;499;127;372;1967
20221203;162;876;168;112;56;1968
20230910;962;286;482;134;348;1969
20220719;855;819;81;36;45;1970
20220711;63;307;110;48;62;1971
20220712;387;354;374;274;100;1972
20220701;387;647;376;218;158;1973
20220209;156;876;154;64;90;1974
20210110;156;308;108;48;60;1975
20230818;634;647;334;329;5;1976
20230421;294;204;258;56;202;1977
20220212;597;307;493;418;75;1978
20230117;156;819;273;238;35;1979
20221203;162;720;346;313;33;1980
20221005;387;286;242;8;234;1981
20230320;962;452;105;64;41;1982
20230205;162;541;221;177;44;1983
20211027;360;825;500;213;287;1984
20230105;181;858;85;50;35;1985
20230806;387;977;471;354;117;1986
20230120;387;354;207;127;80;1987
20230414;387;354;124;56;68;1988
20220710;741;858;271;219;52;1989
20230307;966;351;356;280;76;1990
20220520;966;721;425;259;166;1991
20240804;597;348;152;23;129;1992
20230112;634;567;63;14;49;1993
20220829;63;308;282;259;23;1994
20220918;105;837;156;35;121;1995
20220810;855;876;316;248;68;1996
20220915;524;204;351;31;320;1997
20230904;955;837;346;127;219;1998
20220111;156;204;292;167;125;1999
20230614;962;204;254;95;159;2000
20221029;855;876;292;98;194;2001
20220905;63;541;319;91;228;2002
20230712;162;567;63;7;56;2003
20231205;635;819;302;42;260;2004
20220206;360;567;456;364;92;2005
20220423;294;819;436;1;435;2006
20230505;25;204;428;134;294;2007
20220710;955;452;317;143;174;2008
20220124;634;204;431;365;66;2009
20230729;181;825;98;92;6;2010
20211109;962;348;382;344;38;2011
20220709;635;567;376;360;16;2012
20220910;162;452;267;181;86;2013
20211209;741;876;109;74;35;2014
20220226;635;204;487;275;212;2015
20220503;63;307;324;229;95;2016
20221110;63;567;260;186;74;2017
20221010;156;647;244;219;25;2018
20220520;25;876;411;297;114;2019
20221012;442;837;482;246;236;2020
20220824;955;818;288;177;111;2021
20220526;524;977;364;38;326;2022
20220527;580;720;429;321;108;2023
20220124;196;858;415;32;383;2024
20230124;156;721;87;25;62;2025
20240301;181;354;349;312;37;2026
20220330;294;819;225;190;35;2027
20220810;855;876;405;275;130;2028
20220921;966;286;174;158;16;2029
20220328;387;858;330;88;242;2030
20220310;634;977;234;33;201;2031
20211027;442;837;433;309;124;2032
20220831;442;351;309;83;226;2033
20230719;580;452;192;166;26;2034
20220701;597;825;377;301;76;2035
20211225;360;307;258;32;226;2036
20230110;635;818;67;65;2;2037
20230527;196;348;283;65;218;2038
20230822;156;977;296;11;285;2039
20230808;162;977;215;93;122;2040
20220703;524;647;108;29;79;2041
20230804;63;837;324;79;245;2042
20220528;955;647;384;312;72;2043
20211115;196;204;201;164;37;2044
20211204;25;348;212;47;165;2045
20211108;360;452;252;171;81;2046
20230307;634;348;421;148;273;2047
20230625;597;977;132;102;30;2048
20221014;294;307;118;20;98;2049
20230328;597;308;239;198;41;2050
20220912;63;351;234;91;143;2051
20230204;741;647;419;126;293;2052
20211106;63;819;151;12;139;2053
20211010;156;837;329;25;304;2054
20220910;855;452;346;253;93;2055
20230512;634;825;58;32;26;2056
20221216;580;837;454;305;149;2057
20240206;597;858;162;114;48;2058
20211226;25;354;92;1;91;2059
20220924;387;721;374;313;61;2060
20211117;181;837;63;32;31;2061
20220526;741;876;222;129;93;2062
20220925;524;858;324;36;288;2063
20230310;855;286;325;81;244;2064
20230530;181;204;155;84;71;2065
20230506;955;818;171;79;92;2066
20230427;955;837;451;328;123;2067
20221127;162;286;58;30;28;2068
20230623;25;286;311;154;157;2069
20250109;962;286;329;135;194;2070
20220121;387;351;79;36;43;2071
20220510;181;977;87;56;31;2072
20220421;63;720;259;181;78;2073
20220321;63;286;351;200;151;2074
20211230;442;307;341;42;299;2075
20230111;63;819;113;39;74;2076
20220901;63;721;50;6;44;2077
20230218;294;204;180;177;3;2078
20211023;635;308;465;24;441;2079
20230507;741;977;204;104;100;2080
20230427;955;204;186;116;70;2081
20220331;634;204;434;187;247;2082
20230408;181;348;66;22;44;2083
20220827;360;720;259;184;75;2084
20230218;524;354;97;91;6;2085
20230202;855;308;227;21;206;2086
20230320;63;286;374;77;297;2087
20220611;442;837;243;93;150;2088
20220526;63;819;396;345;51;2089
20211213;442;647;410;138;272;2090
20220305;962;825;446;92;354;2091
20211103;25;819;337;252;85;2092
20231110;63;348;72;64;8;2093
20230915;580;354;65;5;60;2094
20230604;156;567;416;49;367;2095
20221128;524;977;258;146;112;2096
20220124;360;721;357;119;238;2097
20230711;196;837;381;130;251;2098
20220224;855;720;103;58;45;2099
20230802;156;721;323;319;4;2100
20220828;63;837;195;107;88;2101
20220711;294;837;453;94;359;2102
20240110;105;348;152;101;51;2103
20221128;966;876;91;84;7;2104
20220902;966;837;71;26;45;2105
20230914;966;307;124;115;9;2106
20230613;955;308;471;156;315;2107
20230327;635;720;375;271;104;2108
20230812;294;647;93;63;30;2109
20220707;966;308;482;262;220;2110
20220307;25;354;163;133;30;2111
20211117;181;307;424;121;303;2112
20221118;580;452;283;248;35;2113
20221020;524;541;420;240;180;2114
20220611;25;308;403;161;242;2115
20211006;855;647;199;46;153;2116
20230426;524;308;397;226;171;2117
20230716;855;567;450;52;398;2118
20230624;955;308;368;324;44;2119
20211031;524;825;339;137;202;2120
20230803;387;308;295;85;210;2121
20230911;105;876;362;310;52;2122
20220615;580;351;363;105;258;2123
20230818;63;818;420;104;316;2124
20220727;360;825;107;17;90;2125
20220914;955;541;235;202;33;2126
20230804;105;977;104;64;40;2127
20220315;360;567;138;137;1;2128
20230928;524;204;68;5;63;2129
20220130;966;720;464;72;392;2130
20230527;196;818;416;82;334;2131
20230622;196;819;112;15;97;2132
20240509;196;647;364;355;9;2133
20221209;196;977;392;226;166;2134
20220217;25;977;215;132;83;2135
20220126;962;721;288;91;197;2136
20220606;962;977;161;46;115;2137
20220530;387;720;434;112;322;2138
20230823;966;452;145;4;141;2139
20221105;63;837;290;74;216;2140
20230923;580;308;106;17;89;2141
20230115;962;308;98;55;43;2142
20230430;105;977;379;249;130;2143
20220604;524;354;381;275;106;2144
20230309;294;721;329;264;65;2145
20230619;634;819;396;319;77;2146
20220917;741;348;364;362;2;2147
20211015;962;977;449;334;115;2148
20221214;524;837;192;12;180;2149
20230502;360;977;341;202;139;2150
20221126;196;858;341;303;38;2151
20211220;156;348;169;116;53;2152
20220101;955;308;257;208;49;2153
20230506;156;720;365;22;343;2154
20230926;524;818;183;159;24;2155
20230126;63;858;199;198;1;2156
20221110;966;858;202;1;201;2157
20220315;360;308;369;2;367;2158
20220424;63;647;130;14;116;2159
20220429;966;647;66;65;1;2160
20221009;597;541;64;47;17;2161
20220613;580;858;185;16;169;2162
20211014;855;819;213;182;31;2163
20230705;855;720;202;103;99;2164
20230809;25;567;445;1;444;2165
20230720;635;354;61;32;29;2166
20220309;966;286;472;415;57;2167
20230521;25;858;480;20;460;2168
20230220;524;308;391;92;299;2169
20221219;442;354;252;237;15;2170
20230114;524;354;369;215;154;2171
20230629;597;452;236;131;105;2172
20220417;63;819;93;50;43;2173
20230120;105;818;429;236;193;2174
20231212;360;351;137;51;86;2175
20220727;442;286;110;108;2;2176
20230816;181;819;164;56;108;2177
20220406;524;286;233;128;105;2178
20220411;181;204;358;159;199;2179
20211124;25;351;320;274;46;2180
20230603;294;720;491;454;37;2181
20230110;855;307;64;50;14;2182
20220303;360;308;272;113;159;2183
20230712;855;721;124;19;105;2184
20220513;442;720;464;180;284;2185
20220416;962;567;222;71;151;2186
20230527;63;307;337;209;128;2187
20230708;966;286;210;170;40;2188
20220131;524;720;81;19;62;2189
20220627;966;647;144;85;59;2190
20250405;156;876;499;129;370;2191
20220322;63;204;195;93;102;2192
20230307;580;818;300;77;223;2193
20230329;105;858;342;5;337;2194
20220816;360;307;142;90;52;2195
20230602;25;354;206;84;122;2196
20211211;962;721;472;150;322;2197
20230531;635;452;365;15;350;2198
20230311;855;452;267;83;184;2199
20230905;855;876;317;81;236;2200
20230928;196;977;421;72;349;2201
20220105;181;354;386;274;112;2202
20221002;741;307;420;348;72;2203
20230616;580;720;282;170;112;2204
20220525;105;858;368;72;296;2205
20230311;360;308;67;36;31;2206
20240401;580;351;331;140;191;2207
20220308;63;977;94;35;59;2208
20230905;741;837;299;3;296;2209
20220728;597;354;237;190;47;2210
20211231;196;354;376;189;187;2211
20220203;962;204;107;107;0;2212
20220422;524;825;303;125;178;2213
20230921;741;858;370;98;272;2214
20230708;442;720;398;190;208;2215
20240701;360;541;472;434;38;2216
20230406;156;351;469;299;170;2217
20230925;387;819;331;160;171;2218
20221212;63;204;283;235;48;2219
20220903;162;837;210;28;182;2220
20230707;442;858;481;341;140;2221
20221006;156;354;89;10;79;2222
20221114;580;721;245;47;198;2223
20220622;741;819;141;122;19;2224
20230726;635;858;411;2;409;2225
20221122;181;351;340;297;43;2226
20230809;181;721;443;312;131;2227
20221001;634;452;444;394;50;2228
20230909;955;351;395;18;377;2229
20230822;196;837;417;37;380;2230
20221116;162;977;229;35;194;2231
20220514;196;351;490;63;427;2232
20221001;360;348;424;307;117;2233
20240406;634;567;183;127;56;2234
20230514;196;720;335;13;322;2235
20220829;442;825;232;199;33;2236
20220208;63;876;444;17;427;2237
20220318;741;819;275;73;202;2238
20230812;580;308;436;299;137;2239
20230916;442;858;426;153;273;2240
20220504;63;354;159;22;137;2241
20220719;63;567;308;90;218;2242
20230721;196;308;500;219;281;2243
20240606;597;354;244;13;231;2244
20230130;966;307;455;204;251;2245
20211204;597;647;423;332;91;2246
20230621;387;720;293;188;105;2247
20240703;387;567;466;360;106;2248
20240310;387;354;258;153;105;2249
20220806;855;647;60;12;48;2250
20220709;741;354;233;26;207;2251
20220708;955;721;473;281;192;2252
20230308;162;818;110;91;19;2253
20220304;360;977;301;214;87;2254
20230118;387;876;173;68;105;2255
20220527;966;876;312;71;241;2256
20230822;966;286;279;95;184;2257
20211130;196;721;129;65;64;2258
20230925;442;452;379;123;256;2259
20220702;181;541;169;101;68;2260
20221023;360;720;162;161;1;2261
20230820;524;354;57;17;40;2262
20220212;25;818;311;182;129;2263
20230909;741;825;50;25;25;2264
20211031;635;825;483;442;41;2265
20220531;962;351;284;246;38;2266
20230120;634;837;218;12;206;2267
20230915;962;351;297;200;97;2268
20230512;580;354;477;376;101;2269
20230927;156;348;418;20;398;2270
20220618;966;837;332;173;159;2271
20230603;635;452;269;5;264;2272
20220203;855;837;176;63;113;2273
20230303;196;825;343;196;147;2274
20220808;442;818;322;211;111;2275
20230702;580;452;377;250;127;2276
20230914;63;541;180;138;42;2277
20221017;955;721;293;276;17;2278
20230410;580;858;185;108;77;2279
20230217;442;819;155;132;23;2280
20221117;955;354;243;164;79;2281
20221031;855;307;480;120;360;2282
20230716;855;825;405;179;226;2283
20220717;162;876;326;32;294;2284
20221206;63;452;97;2;95;2285
20220817;162;351;435;117;318;2286
20220927;966;348;217;49;168;2287
20230218;634;541;372;45;327;2288
20230515;955;825;290;193;97;2289
20211108;597;351;428;304;124;2290
20230914;597;348;165;28;137;2291
20220910;360;858;252;193;59;2292
20230702;387;354;364;210;154;2293
20220527;634;818;387;380;7;2294
20211202;63;567;185;53;132;2295
20220218;196;818;479;214;265;2296
20220411;962;567;210;63;147;2297
20220803;181;825;335;243;92;2298
20230422;63;308;438;393;45;2299
20220311;25;721;240;224;16;2300
20211007;634;647;209;132;77;2301
20220424;25;819;143;113;30;2302
20230420;962;567;102;11;91;2303
20220904;25;351;354;110;244;2304
20220617;181;818;192;109;83;2305
20220704;855;720;211;19;192;2306
20230511;181;858;91;10;81;2307
20221112;63;452;299;116;183;2308
20221127;442;647;348;312;36;2309
20230203;387;876;500;372;128;2310
20230403;63;837;261;72;189;2311
20220903;634;721;209;121;88;2312
20230201;63;837;245;136;109;2313
20230316;580;307;388;325;63;2314
20220212;360;286;85;69;16;2315
20220611;597;354;170;1;169;2316
20220402;524;720;89;69;20;2317
20220320;156;647;273;244;29;2318
20211225;360;348;482;20;462;2319
20221217;162;977;334;121;213;2320
20220121;442;541;407;268;139;2321
20220218;25;819;78;75;3;2322
20230301;156;858;266;111;155;2323
20230728;635;204;377;29;348;2324
20250608;524;204;250;36;214;2325
20220603;955;348;201;51;150;2326
20230928;360;348;147;53;94;2327
20230607;105;977;385;379;6;2328
20230123;962;567;260;14;246;2329
20221012;635;307;60;23;37;2330
20220505;442;204;330;83;247;2331
20220810;741;977;423;4;419;2332
20211006;580;308;79;63;16;2333
20220301;524;977;83;33;50;2334
20220622;294;825;261;193;68;2335
20211112;181;567;207;164;43;2336
20230101;442;977;205;103;102;2337
20230720;196;876;242;12;230;2338
20230802;524;308;357;56;301;2339
20230809;442;818;168;49;119;2340
20230627;105;819;287;64;223;2341
20221029;580;348;466;274;192;2342
20211128;196;204;304;209;95;2343
20230406;741;541;185;76;109;2344
20220201;63;647;443;252;191;2345
20230202;634;204;404;66;338;2346
20220518;580;204;321;253;68;2347
20230529;442;452;202;136;66;2348
20211119;181;825;393;62;331;2349
20221118;962;354;390;334;56;2350
20221231;105;348;463;6;457;2351
20230819;855;977;136;60;76;2352
20240103;634;819;214;156;58;2353
20211125;63;720;274;128;146;2354
20221020;442;452;496;257;239;2355
20211211;955;354;377;316;61;2356
20220912;524;647;472;96;376;2357
20221116;855;647;153;24;129;2358
20230602;105;286;189;75;114;2359
20221212;634;818;88;27;61;2360
20230718;387;541;377;59;318;2361
20220305;855;286;461;226;235;2362
20220311;63;286;179;143;36;2363
20240905;105;308;78;13;65;2364
20230924;580;351;399;285;114;2365
20220809;181;541;367;251;116;2366
20230217;597;721;385;233;152;2367
20230908;962;819;424;338;86;2368
20220313;442;541;448;1;447;2369
20230611;387;825;308;159;149;2370
20230317;162;286;476;164;312;2371
20220308;855;567;282;48;234;2372
20220816;597;721;253;162;91;2373
20220630;741;720;201;194;7;2374
20221214;855;977;70;10;60;2375
20230823;635;541;302;64;238;2376
20220326;634;354;479;195;284;2377
20221215;63;977;286;186;100;2378
20220304;955;858;201;60;141;2379
20221006;634;819;322;293;29;2380
20220706;360;354;305;31;274;2381
20230730;442;837;365;28;337;2382
20230607;634;286;147;147;0;2383
20230917;360;818;120;16;104;2384
20230106;156;837;132;10;122;2385
20230303;162;720;489;59;430;2386
20230112;360;348;484;202;282;2387
20211209;63;837;187;111;76;2388
20220924;156;858;176;44;132;2389
20220812;196;204;68;13;55;2390
20230328;634;348;423;254;169;2391
20230115;294;307;375;306;69;2392
20211227;580;818;384;241;143;2393
20230105;741;567;58;7;51;2394
20230728;196;351;387;355;32;2395
20220107;63;541;61;34;27;2396
20220101;25;819;430;414;16;2397
20230418;63;204;215;126;89;2398
20230903;156;977;361;106;255;2399
20220413;196;567;108;26;82;2400
20230402;162;351;51;19;32;2401
20220117;634;567;233;161;72;2402
20230912;181;876;241;39;202;2403
20230821;156;204;293;216;77;2404
20230609;962;837;165;23;142;2405
20220407;105;876;455;216;239;2406
20230601;63;858;456;403;53;2407
20220805;63;351;444;36;408;2408
20230406;634;721;311;157;154;2409
20230103;63;351;215;202;13;2410
20230422;635;819;211;120;91;2411
20230423;635;720;161;89;72;2412
20230922;162;348;420;292;128;2413
20211121;442;351;318;228;90;2414
20230920;181;977;426;390;36;2415
20220901;63;647;398;57;341;2416
20221024;580;819;123;28;95;2417
20210930;181;858;458;55;403;2418
20221123;442;819;305;111;194;2419
20220123;360;977;305;132;173;2420
20230608;162;647;443;146;297;2421
20230506;105;837;361;347;14;2422
20221115;635;286;66;17;49;2423
20230312;196;452;456;447;9;2424
20211022;635;858;108;71;37;2425
20220704;524;720;135;50;85;2426
20230323;105;286;407;1;406;2427
20220905;634;825;133;93;40;2428
20211027;634;351;101;64;37;2429
20211122;156;204;462;202;260;2430
20220722;855;354;180;133;47;2431
20211108;387;541;270;268;2;2432
20231008;855;819;271;25;246;2433
20230323;442;837;371;237;134;2434
20230609;294;351;162;101;61;2435
20220623;156;720;178;71;107;2436
20211014;360;876;184;71;113;2437
20230808;162;308;99;7;92;2438
20221101;635;837;131;124;7;2439
20220516;955;567;304;106;198;2440
20220526;294;354;157;79;78;2441
20211023;597;567;231;152;79;2442
20220704;105;204;500;93;407;2443
20230511;634;286;114;12;102;2444
20230618;25;307;129;7;122;2445
20220625;105;307;66;39;27;2446
20220903;962;286;322;31;291;2447
20220601;63;977;451;147;304;2448
20220119;63;354;432;394;38;2449
20211121;597;721;415;307;108;2450
20230703;855;567;70;17;53;2451
20220228;156;647;375;295;80;2452
20240309;294;720;111;22;89;2453
20220515;966;837;160;19;141;2454
20220810;105;286;436;158;278;2455
20220331;524;351;87;84;3;2456
20220103;156;819;485;389;96;2457
20211226;966;977;391;175;216;2458
20211112;196;286;467;62;405;2459
20230327;634;977;361;21;340;2460
20220112;855;837;81;9;72;2461
20230221;634;307;433;141;292;2462
20240404;955;858;145;145;0;2463
20220125;524;307;132;82;50;2464
20230111;63;204;417;294;123;2465
20211011;855;351;101;56;45;2466
20210411;196;825;408;337;71;2467
20211207;634;977;336;237;99;2468
20211002;597;308;53;52;1;2469
20211007;196;541;210;112;98;2470
20230113;156;541;104;99;5;2471
20230824;580;452;380;205;175;2472
20220112;196;348;132;71;61;2473
20230801;105;876;112;46;66;2474
20220327;962;647;222;61;161;2475
20230716;196;541;446;410;36;2476
20220101;635;541;207;189;18;2477
20211026;162;818;384;114;270;2478
20220815;156;818;322;65;257;2479
20220219;634;818;140;45;95;2480
20230615;524;721;419;112;307;2481
20221225;966;721;69;7;62;2482
20220402;360;858;296;95;201;2483
20221102;63;307;89;34;55;2484
20230709;156;647;193;161;32;2485
20230705;156;452;311;277;34;2486
20220106;63;977;376;9;367;2487
20230818;580;858;253;151;102;2488
20220130;634;858;195;180;15;2489
20230721;955;876;54;25;29;2490
20221204;25;354;322;64;258;2491
20221222;360;818;372;329;43;2492
20220516;524;348;369;105;264;2493
20230602;156;452;366;133;233;2494
20220619;63;858;417;96;321;2495
20230105;524;858;173;136;37;2496
20211116;580;452;266;220;46;2497
20211004;63;818;160;44;116;2498
20220817;524;351;159;145;14;2499
20220126;25;286;58;16;42;2500
20230317;442;818;443;251;192;2501
20220603;955;647;419;116;303;2502
20240702;387;348;217;197;20;2503
20220610;580;837;270;214;56;2504
20230718;181;308;434;152;282;2505
20220324;580;819;489;102;387;2506
20211210;741;307;118;87;31;2507
20220504;635;351;59;51;8;2508
20220617;442;307;94;58;36;2509
20230802;156;204;436;157;279;2510
20230213;634;837;195;174;21;2511
20220825;156;541;323;143;180;2512
20220424;294;837;467;111;356;2513
20230514;387;541;464;445;19;2514
20211122;597;541;263;230;33;2515
20230207;635;876;241;59;182;2516
20230426;524;307;292;103;189;2517
20241103;580;286;230;223;7;2518
20220409;63;204;471;97;374;2519
20230911;156;204;244;83;161;2520
20220325;105;647;211;72;139;2521
20220324;156;720;426;328;98;2522
20221029;442;876;198;144;54;2523
20230909;63;348;53;45;8;2524
20220408;855;825;174;7;167;2525
20220425;442;721;139;18;121;2526
20220711;360;977;422;341;81;2527
20220802;442;308;215;65;150;2528
20220108;634;818;243;82;161;2529
20230421;294;307;251;76;175;2530
20230220;855;567;66;39;27;2531
20211019;524;452;258;182;76;2532
20230903;524;825;222;197;25;2533
20220904;955;818;453;14;439;2534
20230413;580;308;351;320;31;2535
20230915;387;307;97;68;29;2536
20220103;63;286;270;10;260;2537
20211227;524;354;182;32;150;2538
20211102;597;819;375;39;336;2539
20230917;360;858;406;102;304;2540
20220606;524;876;474;226;248;2541
20240211;360;858;320;206;114;2542
20230504;966;307;292;50;242;2543
20221011;294;858;248;8;240;2544
20220214;741;720;479;220;259;2545
20230206;294;348;449;70;379;2546
20230112;156;825;414;262;152;2547
20220117;181;818;419;394;25;2548
20220519;181;307;380;103;277;2549
20230710;162;837;330;304;26;2550
20220212;955;858;347;285;62;2551
20221218;524;825;293;250;43;2552
20230908;387;204;146;42;104;2553
20230104;962;354;440;331;109;2554
20220317;25;720;391;258;133;2555
20211025;294;286;298;176;122;2556
20230625;524;286;331;285;46;2557
20221102;360;351;499;245;254;2558
20230407;955;647;371;328;43;2559
20220302;387;647;94;60;34;2560
20211111;294;825;132;89;43;2561
20240106;597;977;59;4;55;2562
20211124;855;721;233;55;178;2563
20250503;855;452;298;230;68;2564
20220321;524;307;213;91;122;2565
20230724;63;858;107;51;56;2566
20230708;741;307;390;10;380;2567
20230326;962;858;389;51;338;2568
20220905;387;567;397;70;327;2569
20211205;962;286;122;27;95;2570
20220306;294;721;140;98;42;2571
20220801;181;567;154;126;28;2572
20230818;25;307;396;62;334;2573
20230909;966;452;223;189;34;2574
20250703;162;876;434;419;15;2575
20221031;294;876;218;203;15;2576
20220209;360;286;134;97;37;2577
20230715;387;348;261;191;70;2578
20230602;360;647;292;187;105;2579
20220605;524;286;154;83;71;2580
20230119;635;876;212;98;114;2581
20220210;156;541;269;101;168;2582
20230926;196;204;61;24;37;2583
20220714;181;308;74;45;29;2584
20221107;294;977;155;57;98;2585
20211004;635;452;201;14;187;2586
20221211;387;977;274;163;111;2587
20230823;962;825;380;93;287;2588
20240408;580;720;191;125;66;2589
20230413;63;876;462;179;283;2590
20221008;63;720;263;183;80;2591
20230703;63;351;228;28;200;2592
20220518;966;876;112;56;56;2593
20230721;855;647;474;217;257;2594
20211208;955;819;238;160;78;2595
20220727;25;819;198;69;129;2596
20220716;580;876;376;131;245;2597
20220201;156;351;225;73;152;2598
20250406;597;541;380;184;196;2599
20220314;635;286;477;419;58;2600
20220812;156;567;279;9;270;2601
20220409;597;348;338;143;195;2602
20221109;360;204;226;124;102;2603
20230720;524;354;410;373;37;2604
20240305;442;720;87;35;52;2605
20230117;966;452;102;64;38;2606
20220122;156;818;82;78;4;2607
20221210;966;819;439;173;266;2608
20220510;162;876;307;152;155;2609
20230707;162;286;448;99;349;2610
20220425;634;452;307;83;224;2611
20220519;855;307;277;217;60;2612
20220917;635;977;440;172;268;2613
20220819;63;308;97;75;22;2614
20220108;635;876;223;153;70;2615
20220302;855;307;209;193;16;2616
20220919;360;348;145;102;43;2617
20230630;360;452;254;107;147;2618
20220704;162;308;329;274;55;2619
20220602;63;858;195;171;24;2620
20230526;25;351;124;112;12;2621
20220207;181;567;281;241;40;2622
20220316;181;204;298;283;15;2623
20211111;294;876;123;91;32;2624
20230423;196;818;345;61;284;2625
20211114;597;348;469;420;49;2626
20230102;855;354;107;57;50;2627
20220925;634;977;445;62;383;2628
20221207;966;647;206;194;12;2629
20220304;181;286;452;344;108;2630
20211227;635;354;368;100;268;2631
20220401;63;977;487;318;169;2632
20220324;294;286;343;334;9;2633
20230526;360;351;218;165;53;2634
20211124;580;720;461;98;363;2635
20220729;63;354;168;167;1;2636
20220310;442;858;119;24;95;2637
20211213;966;819;463;24;439;2638
20220602;360;819;90;32;58;2639
20220322;105;351;136;12;124;2640
20220415;181;721;320;312;8;2641
20220118;962;354;430;352;78;2642
20220624;966;567;126;110;16;2643
20220306;196;647;492;380;112;2644
20231109;162;837;255;35;220;2645
20221110;442;720;78;62;16;2646
20220617;181;858;500;477;23;2647
20220305;962;876;148;71;77;2648
20220811;294;647;110;110;0;2649
20220324;387;858;323;212;111;2650
20221216;741;567;284;46;238;2651
20230609;196;348;359;30;329;2652
20211129;597;452;108;4;104;2653
20230622;63;567;119;65;54;2654
20230719;181;825;433;60;373;2655
20220102;741;721;207;159;48;2656
20211105;294;818;72;37;35;2657
20230426;294;819;312;50;262;2658
20230826;162;308;65;9;56;2659
20220531;196;452;80;9;71;2660
20211121;25;858;400;100;300;2661
20211229;25;541;446;430;16;2662
20220813;25;204;189;16;173;2663
20220506;855;348;279;137;142;2664
20220829;105;825;448;95;353;2665
20221027;634;977;395;265;130;2666
20230913;962;204;95;15;80;2667
20230503;294;647;408;214;194;2668
20230729;855;541;237;96;141;2669
20230504;442;354;421;48;373;2670
20230916;855;308;368;178;190;2671
20230717;181;204;69;45;24;2672
20231006;63;204;131;37;94;2673
20221216;196;647;215;56;159;2674
20230520;741;858;203;54;149;2675
20211006;25;354;142;14;128;2676
20221021;855;204;333;265;68;2677
20211120;962;837;74;2;72;2678
20230628;442;286;222;110;112;2679
20230607;105;977;361;320;41;2680
20220302;63;541;353;105;248;2681
20230725;524;647;199;83;116;2682
20221216;580;308;217;37;180;2683
20210929;63;308;450;376;74;2684
20240601;966;977;470;76;394;2685
20220303;955;647;90;7;83;2686
20230806;360;452;186;42;144;2687
20220109;635;348;176;17;159;2688
20220406;524;286;461;130;331;2689
20220423;634;876;78;52;26;2690
20230514;855;541;126;33;93;2691
20231103;634;720;220;63;157;2692
20230504;966;351;272;217;55;2693
20220705;597;307;71;3;68;2694
20230506;294;721;263;236;27;2695
20230707;442;720;404;134;270;2696
20230104;442;308;173;11;162;2697
20220401;25;818;81;7;74;2698
20221125;524;837;483;250;233;2699
20230703;156;876;205;165;40;2700
20230919;597;721;354;88;266;2701
20220618;294;858;142;28;114;2702
20230124;162;286;422;345;77;2703
20220823;855;286;95;34;61;2704
20230707;63;348;191;96;95;2705
20230227;597;567;330;119;211;2706
20230906;741;819;323;251;72;2707
20220412;741;204;116;45;71;2708
20220730;156;721;216;206;10;2709
20230109;442;452;218;35;183;2710
20211112;524;876;281;193;88;2711
20220915;580;819;225;165;60;2712
20230527;63;452;489;362;127;2713
20211102;524;818;478;362;116;2714
20220912;442;308;256;151;105;2715
20221126;63;541;234;108;126;2716
20230122;181;837;337;251;86;2717
20220311;162;876;430;290;140;2718
20211125;63;721;285;120;165;2719
20230810;442;977;142;59;83;2720
20230526;63;720;240;220;20;2721
20230119;580;819;109;1;108;2722
20230126;63;348;210;156;54;2723
20230614;855;858;401;188;213;2724
20230728;966;286;297;18;279;2725
20230630;442;204;77;22;55;2726
20230519;442;818;96;53;43;2727
20221118;855;818;126;65;61;2728
20220626;387;837;332;12;320;2729
20230902;962;286;312;199;113;2730
20230204;962;721;372;260;112;2731
20230523;294;348;97;87;10;2732
20221031;635;837;67;36;31;2733
20230130;156;567;217;130;87;2734
20230507;634;348;329;262;67;2735
20220620;156;307;456;183;273;2736
20221209;63;721;181;30;151;2737
20211015;634;308;347;227;120;2738
20220319;597;452;250;169;81;2739
20220801;855;721;430;226;204;2740
20230919;63;354;282;34;248;2741
20211020;855;286;358;232;126;2742
20211125;25;818;55;41;14;2743
20230103;741;858;265;56;209;2744
20211031;196;858;369;127;242;2745
20230801;105;452;212;151;61;2746
20220318;962;876;269;74;195;2747
20230616;741;858;436;229;207;2748
20230702;966;452;204;80;124;2749
20230206;196;567;200;123;77;2750
20230320;962;977;193;87;106;2751
20220903;196;720;116;63;53;2752
20230408;360;647;209;176;33;2753
20220711;162;354;241;22;219;2754
20240108;597;348;460;222;238;2755
20230619;181;977;297;70;227;2756
20230605;524;351;264;251;13;2757
20230218;855;858;109;20;89;2758
20220501;580;452;195;100;95;2759
20221215;196;204;400;212;188;2760
20221107;524;720;462;283;179;2761
20230108;63;351;406;67;339;2762
20220531;360;858;50;40;10;2763
20220305;63;354;130;11;119;2764
20230110;855;825;287;54;233;2765
20220919;966;837;455;389;66;2766
20230104;966;977;353;235;118;2767
20211129;360;307;96;20;76;2768
20221125;156;819;445;137;308;2769
20230321;442;351;430;176;254;2770
20230429;25;308;170;133;37;2771
20240401;105;647;423;412;11;2772
20240505;63;825;397;182;215;2773
20220823;360;348;220;20;200;2774
20230629;63;819;407;110;297;2775
20220403;294;204;334;143;191;2776
20221119;156;876;80;68;12;2777
20220128;181;351;111;64;47;2778
20220811;524;647;404;131;273;2779
20230808;597;351;84;30;54;2780
20220708;63;825;454;284;170;2781
20220911;741;720;469;36;433;2782
20220814;962;977;306;280;26;2783
20221012;955;647;66;19;47;2784
20220201;580;351;238;9;229;2785
20211109;156;977;157;6;151;2786
20220114;442;307;431;289;142;2787
20220515;162;721;256;167;89;2788
20230703;524;721;239;92;147;2789
20220211;387;567;235;75;160;2790
20220301;63;452;425;123;302;2791
20221107;105;348;464;78;386;2792
20230131;634;819;69;49;20;2793
20230327;360;307;200;93;107;2794
20220512;855;977;387;238;149;2795
20230121;360;308;200;148;52;2796
20221128;387;354;366;122;244;2797
20220826;360;204;107;38;69;2798
20211013;105;721;290;107;183;2799
20230103;635;308;105;28;77;2800
20230812;635;567;155;44;111;2801
20220218;360;721;219;41;178;2802
20230109;955;647;480;159;321;2803
20230718;741;837;156;6;150;2804
20221216;580;354;272;11;261;2805
20211216;105;825;457;145;312;2806
20230123;162;204;336;313;23;2807
20220203;196;307;64;12;52;2808
20220123;63;837;446;231;215;2809
20230124;105;348;364;323;41;2810
20230614;635;720;85;27;58;2811
20220926;955;721;165;162;3;2812
20211022;63;452;269;228;41;2813
20220917;955;286;220;219;1;2814
20211107;162;354;348;119;229;2815
20230304;962;452;291;286;5;2816
20230417;955;858;135;48;87;2817
20221216;741;720;55;40;15;2818
20211031;962;354;143;143;0;2819
20220123;635;825;424;414;10;2820
20220725;966;825;206;67;139;2821
20220311;360;837;427;397;30;2822
20211017;955;286;155;136;19;2823
20230904;635;351;359;82;277;2824
20230410;387;567;344;166;178;2825
20211206;387;204;344;334;10;2826
20230428;181;204;96;20;76;2827
20230912;25;721;75;59;16;2828
20230705;294;307;128;35;93;2829
20211102;741;452;378;30;348;2830
20221105;442;308;146;3;143;2831
20221027;162;452;64;60;4;2832
20220612;196;286;247;202;45;2833
20211027;524;818;276;127;149;2834
20220228;63;721;347;264;83;2835
20211204;855;307;289;21;268;2836
20230329;966;286;222;163;59;2837
20221110;855;647;389;241;148;2838
20230819;196;819;284;123;161;2839
20230507;63;647;373;82;291;2840
20230908;635;977;498;24;474;2841
20230224;955;858;96;27;69;2842
20230712;855;858;278;221;57;2843
20220320;634;307;73;53;20;2844
20230817;966;308;279;210;69;2845
20240504;387;567;450;216;234;2846
20211226;962;977;445;220;225;2847
20230621;63;348;434;334;100;2848
20211023;294;204;206;109;97;2849
20220926;63;647;110;35;75;2850
20220513;855;818;96;15;81;2851
20230722;966;351;264;12;252;2852
20220728;63;567;116;80;36;2853
20211003;966;825;80;70;10;2854
20230103;63;286;152;97;55;2855
20230430;955;541;86;18;68;2856
20220206;955;541;89;49;40;2857
20221109;855;858;175;38;137;2858
20250707;597;818;267;61;206;2859
20220126;181;354;270;88;182;2860
20221026;741;452;144;139;5;2861
20211127;196;351;265;123;142;2862
20230927;294;354;402;386;16;2863
20241202;294;977;482;341;141;2864
20221125;63;348;277;14;263;2865
20230428;524;818;419;241;178;2866
20230508;741;876;180;1;179;2867
20230606;580;307;100;7;93;2868
20220527;387;204;58;23;35;2869
20230718;360;307;161;56;105;2870
20230414;162;308;367;169;198;2871
20220701;181;354;494;122;372;2872
20211107;597;348;354;233;121;2873
20230122;156;818;179;85;94;2874
20221018;955;308;380;61;319;2875
20220728;955;204;143;56;87;2876
20230506;597;307;428;255;173;2877
20230405;634;825;258;142;116;2878
20220123;181;541;442;210;232;2879
20230128;855;286;255;89;166;2880
20220426;387;567;83;16;67;2881
20240306;181;647;223;46;177;2882
20220429;294;452;95;43;52;2883
20230123;955;354;100;34;66;2884
20230729;966;819;368;92;276;2885
20211128;855;825;272;180;92;2886
20230404;181;567;384;73;311;2887
20210929;955;977;373;123;250;2888
20240704;955;721;128;40;88;2889
20220524;597;567;457;136;321;2890
20250108;360;354;259;196;63;2891
20211018;360;204;63;38;25;2892
20230803;196;348;84;5;79;2893
20230525;442;818;290;122;168;2894
20230411;741;286;232;87;145;2895
20210930;63;307;393;228;165;2896
20230404;360;818;164;59;105;2897
20230629;105;721;282;109;173;2898
20220113;855;818;454;192;262;2899
20230419;360;348;449;97;352;2900
20221021;635;351;493;485;8;2901
20220530;196;819;259;229;30;2902
20230604;105;308;254;161;93;2903
20220213;634;308;136;15;121;2904
20211005;955;541;323;71;252;2905
20230603;63;837;180;28;152;2906
20230331;196;286;240;193;47;2907
20250305;597;818;90;9;81;2908
20230826;741;647;301;16;285;2909
20220718;580;567;360;241;119;2910
20220801;962;825;224;20;204;2911
20220426;63;541;410;27;383;2912
20220325;294;204;455;130;325;2913
20220727;63;307;93;26;67;2914
20230726;635;567;124;76;48;2915
20220707;196;204;283;49;234;2916
20211123;962;541;278;109;169;2917
20220612;156;647;213;15;198;2918
20240505;162;825;235;25;210;2919
20211023;294;819;206;126;80;2920
20240109;634;452;363;353;10;2921
20221101;181;286;207;165;42;2922
20230905;855;818;417;149;268;2923
20230326;156;818;385;142;243;2924
20230724;360;647;492;19;473;2925
20220523;855;647;392;66;326;2926
20230716;955;351;400;367;33;2927
20221009;387;818;476;151;325;2928
20221202;966;721;397;11;386;2929
20220315;63;647;440;293;147;2930
20230405;63;351;440;358;82;2931
20230517;962;351;329;123;206;2932
20220905;162;876;329;50;279;2933
20230709;741;541;160;150;10;2934
20220812;524;837;381;331;50;2935
20221007;741;818;407;76;331;2936
20220204;25;541;142;49;93;2937
20230516;741;647;210;150;60;2938
20240909;360;348;218;31;187;2939
20220603;741;567;297;42;255;2940
20230719;524;858;260;122;138;2941
20230914;63;721;132;99;33;2942
20220112;966;977;412;156;256;2943
20230103;162;204;118;42;76;2944
20211102;196;307;209;187;22;2945
20211206;855;977;206;110;96;2946
20220916;162;720;447;61;386;2947
20220402;162;720;420;266;154;2948
20220506;360;567;157;90;67;2949
20211019;181;858;229;165;64;2950
20230228;966;348;154;133;21;2951
20230317;105;876;247;198;49;2952
20211230;966;720;205;77;128;2953
20230502;181;204;265;159;106;2954
20230805;196;858;236;159;77;2955
20221109;156;354;307;304;3;2956
20211229;962;819;475;322;153;2957
20220511;162;307;300;205;95;2958
20230720;196;825;169;157;12;2959
20230902;634;825;313;87;226;2960
20230101;162;354;296;277;19;2961
20221126;524;541;357;185;172;2962
20240102;524;858;160;38;122;2963
20230408;597;819;192;55;137;2964
20221216;955;647;373;39;334;2965
20220410;855;825;137;57;80;2966
20220507;741;204;411;120;291;2967
20220930;196;348;361;285;76;2968
20230211;966;647;270;152;118;2969
20220221;181;204;262;47;215;2970
20221221;162;825;53;1;52;2971
20230926;966;858;78;44;34;2972
20230416;387;452;58;31;27;2973
20230513;387;858;146;96;50;2974
20230204;162;720;156;127;29;2975
20230722;635;837;447;233;214;2976
20221023;162;825;413;24;389;2977
20211014;962;567;341;208;133;2978
20220702;63;858;200;54;146;2979
20220813;442;720;462;427;35;2980
20220529;63;837;496;351;145;2981
20221229;580;819;206;195;11;2982
20230402;580;721;355;299;56;2983
20230722;597;348;426;288;138;2984
20230328;855;825;158;81;77;2985
20220209;634;819;293;104;189;2986
20220907;387;858;122;72;50;2987
20230629;25;286;357;243;114;2988
20220524;387;286;107;94;13;2989
20250305;741;818;135;81;54;2990
20230513;25;876;481;439;42;2991
20230420;162;567;271;245;26;2992
20210710;855;819;92;51;41;2993
20230726;105;452;78;59;19;2994
20230831;634;721;126;102;24;2995
20221203;955;720;289;276;13;2996
20230207;162;204;310;168;142;2997
20220413;387;307;195;61;134;2998
20230214;855;354;211;183;28;2999
20230313;634;348;451;49;402;3000
20230423;156;348;487;6;481;3001
20220623;635;348;182;155;27;3002
20230414;181;825;395;312;83;3003
20220331;741;351;381;173;208;3004
20221231;196;204;248;61;187;3005
20220602;196;721;119;10;109;3006
20211121;360;977;244;136;108;3007
20230610;387;825;465;404;61;3008
20211009;156;858;279;68;211;3009
20221109;741;567;492;82;410;3010
20221004;962;348;60;50;10;3011
20220711;597;819;187;8;179;3012
20211221;162;307;492;250;242;3013
20230729;25;818;360;335;25;3014
20230814;25;541;271;123;148;3015
20230503;387;567;404;81;323;3016
20221115;360;858;96;92;4;3017
20230516;156;308;343;219;124;3018
20220805;360;876;233;203;30;3019
20230609;181;720;349;293;56;3020
20240409;741;876;99;68;31;3021
20230518;741;541;339;49;290;3022
20220109;387;452;195;182;13;3023
20230510;162;818;314;276;38;3024
20230914;962;819;335;66;269;3025
20220602;955;825;430;335;95;3026
20220617;63;825;126;119;7;3027
20220613;855;647;443;356;87;3028
20220508;634;721;211;195;16;3029
20220217;634;348;444;344;100;3030
20221120;63;286;213;4;209;3031
20230422;634;204;165;28;137;3032
20230209;635;720;114;56;58;3033
20220221;741;204;376;211;165;3034
20211019;105;541;186;21;165;3035
20220517;25;876;474;53;421;3036
20230125;63;351;209;49;160;3037
20210928;962;354;219;174;45;3038
20220215;442;647;104;89;15;3039
20220105;156;647;88;30;58;3040
20220730;634;452;187;41;146;3041
20220901;524;351;400;174;226;3042
20220813;25;204;233;95;138;3043
20221126;580;819;429;256;173;3044
20211210;387;286;86;70;16;3045
20230908;181;308;249;121;128;3046
20211018;741;977;186;35;151;3047
20220808;741;541;101;46;55;3048
20221120;294;286;267;191;76;3049
20230324;634;308;289;243;46;3050
20230417;635;307;190;152;38;3051
20220701;63;567;160;18;142;3052
20220712;25;647;404;181;223;3053
20211210;580;819;473;259;214;3054
20221126;181;858;303;271;32;3055
20211217;442;825;416;269;147;3056
20230517;962;308;288;265;23;3057
20230224;360;647;308;38;270;3058
20220910;962;308;168;73;95;3059
20230715;181;452;454;93;361;3060
20230211;294;307;475;386;89;3061
20220523;25;351;234;3;231;3062
20221126;580;541;90;47;43;3063
20211209;955;541;210;11;199;3064
20240604;196;307;346;44;302;3065
20230922;196;977;487;89;398;3066
20220329;25;837;124;11;113;3067
20220107;294;647;316;37;279;3068
20240205;162;354;271;100;171;3069
20220618;962;818;436;51;385;3070
20220313;962;351;461;101;360;3071
20230629;597;818;62;36;26;3072
20230216;156;308;494;358;136;3073
20220125;855;307;143;68;75;3074
20230928;855;204;166;53;113;3075
20211013;63;837;51;41;10;3076
20230309;966;452;445;211;234;3077
20220310;962;818;395;293;102;3078
20220903;181;647;344;198;146;3079
20230202;156;647;187;17;170;3080
20221109;741;647;255;146;109;3081
20230801;105;307;365;55;310;3082
20230312;387;721;488;482;6;3083
20230128;63;567;421;61;360;3084
20230901;597;818;237;15;222;3085
20230808;855;858;93;56;37;3086
20230221;855;876;234;43;191;3087
20221001;156;647;235;110;125;3088
20220803;25;825;426;12;414;3089
20211018;162;818;111;74;37;3090
20230713;387;818;481;279;202;3091
20220304;962;307;318;243;75;3092
20230411;580;720;472;389;83;3093
20221212;634;308;440;243;197;3094
20230519;294;452;136;103;33;3095
20230408;580;858;97;87;10;3096
20230908;597;348;261;33;228;3097
20220819;162;647;95;22;73;3098
20211017;63;348;445;271;174;3099
20230317;387;348;232;142;90;3100
20230826;966;567;57;3;54;3101
20220421;360;541;197;5;192;3102
20220627;25;720;420;216;204;3103
20231005;63;308;496;266;230;3104
20220518;597;837;429;404;25;3105
20230331;962;541;327;34;293;3106
20221121;524;348;211;73;138;3107
20220403;63;286;266;130;136;3108
20230518;597;204;65;12;53;3109
20220101;635;818;178;167;11;3110
20220516;524;204;52;11;41;3111
20220305;962;825;359;212;147;3112
20220806;966;307;449;188;261;3113
20230408;196;721;227;41;186;3114
20211205;63;452;250;100;150;3115
20211222;962;721;409;184;225;3116
20230809;196;858;205;18;187;3117
20220529;294;541;387;307;80;3118
20220922;966;825;171;91;80;3119
20220808;442;825;360;329;31;3120
20241208;63;348;100;35;65;3121
20230203;63;818;482;425;57;3122
20221015;635;348;391;78;313;3123
20220207;387;720;128;1;127;3124
20220701;105;204;422;78;344;3125
20221124;955;204;461;396;65;3126
20220518;294;858;201;118;83;3127
20230731;635;858;112;25;87;3128
20220506;105;567;353;155;198;3129
20211228;955;351;441;343;98;3130
20220224;962;452;255;206;49;3131
20220521;63;720;59;23;36;3132
20230820;635;452;344;281;63;3133
20230829;387;204;471;166;305;3134
20220122;360;307;168;46;122;3135
20220815;741;720;232;217;15;3136
20230119;105;720;375;320;55;3137
20220425;294;825;377;10;367;3138
20220320;442;351;242;222;20;3139
20220205;524;819;75;20;55;3140
20220606;580;307;195;54;141;3141
20230527;634;541;444;246;198;3142
20220101;855;354;330;137;193;3143
20230729;387;348;433;387;46;3144
20221006;105;351;397;317;80;3145
20220103;524;837;148;51;97;3146
20220131;955;307;369;312;57;3147
20230925;162;818;218;144;74;3148
20211024;196;837;109;2;107;3149
20210510;634;837;114;85;29;3150
20220221;634;837;205;200;5;3151
20211209;955;977;292;93;199;3152
20220910;156;876;196;11;185;3153
20250408;855;351;416;190;226;3154
20230629;955;825;356;57;299;3155
20230914;855;204;174;39;135;3156
20210930;741;858;267;237;30;3157
20230501;156;541;178;24;154;3158
20230427;294;351;259;254;5;3159
20211012;105;307;499;69;430;3160
20230717;955;204;218;53;165;3161
20230831;634;858;254;58;196;3162
20230307;63;348;296;168;128;3163
20221020;442;541;116;109;7;3164
20220309;634;977;251;152;99;3165
20230417;580;308;303;149;154;3166
20230907;196;647;236;57;179;3167
20220528;635;837;103;7;96;3168
20230503;63;351;305;259;46;3169
20230807;962;721;358;9;349;3170
20230422;196;307;263;21;242;3171
20230112;597;351;85;35;50;3172
20230905;955;721;372;199;173;3173
20230616;294;286;341;92;249;3174
20220422;294;819;119;6;113;3175
20211008;634;720;66;9;57;3176
20220501;196;308;399;116;283;3177
20220713;962;567;95;59;36;3178
20221205;597;286;220;208;12;3179
20220814;855;720;363;339;24;3180
20211016;962;204;120;69;51;3181
20230902;966;876;397;103;294;3182
20250201;162;354;211;81;130;3183
20221207;25;858;104;98;6;3184
20220223;524;541;382;39;343;3185
20221008;156;567;493;167;326;3186
20220801;741;567;341;133;208;3187
20220530;196;541;454;429;25;3188
20230617;741;307;302;2;300;3189
20220411;63;541;277;200;77;3190
20230416;360;308;300;124;176;3191
20230530;955;819;236;39;197;3192
20230403;442;858;159;16;143;3193
20230712;196;567;440;42;398;3194
20220621;855;837;261;106;155;3195
20241106;196;348;148;27;121;3196
20230903;105;837;457;377;80;3197
20221220;635;348;343;94;249;3198
20221103;442;647;406;2;404;3199
20220706;855;541;472;308;164;3200
20220808;580;977;217;120;97;3201
20221205;156;819;267;146;121;3202
20230129;635;858;345;245;100;3203
20221026;635;647;400;155;245;3204
20221014;63;286;435;37;398;3205
20220417;25;858;229;160;69;3206
20221015;294;308;181;162;19;3207
20230404;597;819;211;192;19;3208
20230903;162;720;136;22;114;3209
20230803;634;837;144;28;116;3210
20220320;966;348;62;14;48;3211
20230801;387;837;171;131;40;3212
20211223;597;825;209;190;19;3213
20220504;63;858;368;103;265;3214
20220717;580;286;130;30;100;3215
20211203;294;858;307;220;87;3216
20221002;741;354;448;285;163;3217
20220723;955;876;184;67;117;3218
20220304;162;858;138;29;109;3219
20230105;442;351;167;162;5;3220
20220130;387;567;430;408;22;3221
20220528;294;567;202;50;152;3222
20220102;196;720;264;163;101;3223
20211225;156;825;118;24;94;3224
20220619;63;348;414;66;348;3225
20220629;63;647;488;485;3;3226
20220502;105;541;244;189;55;3227
20230726;966;819;324;179;145;3228
20230401;855;825;369;35;334;3229
20230908;294;721;484;359;125;3230
20220612;966;204;243;212;31;3231
20221003;442;647;479;201;278;3232
20221219;156;858;235;23;212;3233
20250204;524;647;194;141;53;3234
20230911;962;837;447;258;189;3235
20230809;105;308;64;37;27;3236
20230626;25;977;293;32;261;3237
20230323;634;647;334;23;311;3238
20230724;196;818;496;336;160;3239
20220506;635;647;302;189;113;3240
20230217;181;351;422;108;314;3241
20230608;635;720;228;52;176;3242
20230516;635;721;198;138;60;3243
20220506;955;837;244;57;187;3244
20211103;962;837;270;104;166;3245
20211215;634;452;408;139;269;3246
20211203;442;825;386;20;366;3247
20230723;634;858;88;86;2;3248
20230604;580;825;147;100;47;3249
20220108;524;876;302;50;252;3250
20220512;966;204;199;41;158;3251
20220701;634;858;236;152;84;3252
20220108;105;354;102;87;15;3253
20211023;25;858;335;42;293;3254
20220104;360;858;180;101;79;3255
20230506;63;204;196;29;167;3256
20220729;63;721;401;159;242;3257
20230611;181;286;219;48;171;3258
20230917;635;308;355;212;143;3259
20240805;966;825;188;151;37;3260
20230309;162;541;272;119;153;3261
20220722;63;452;423;412;11;3262
20221127;962;348;344;198;146;3263
20220213;741;720;92;82;10;3264
20221204;442;286;496;429;67;3265
20240501;597;308;372;327;45;3266
20230528;597;876;257;126;131;3267
20230304;63;876;406;163;243;3268
20220116;524;308;57;39;18;3269
20230102;634;351;444;12;432;3270
20230329;294;876;354;142;212;3271
20220101;294;825;137;10;127;3272
20220123;741;348;257;61;196;3273
20221102;635;876;117;28;89;3274
20220226;580;541;293;111;182;3275
20230617;524;721;335;245;90;3276
20211105;25;647;488;254;234;3277
20210929;597;720;170;101;69;3278
20230510;63;348;104;103;1;3279
20250506;966;825;241;203;38;3280
20211121;855;567;486;159;327;3281
20221223;360;720;392;290;102;3282
20230411;524;647;151;101;50;3283
20220312;962;354;115;60;55;3284
20230403;105;647;453;371;82;3285
20220919;634;721;217;28;189;3286
20221028;741;307;212;101;111;3287
20211118;524;825;500;260;240;3288
20220110;855;354;391;306;85;3289
20221118;196;720;165;114;51;3290
20220604;634;567;366;109;257;3291
20221021;63;204;136;86;50;3292
20230928;25;307;208;117;91;3293
20220320;955;286;80;64;16;3294
20220909;156;567;487;281;206;3295
20230712;741;308;288;23;265;3296
20230601;294;858;404;40;364;3297
20230310;294;818;291;195;96;3298
20230407;966;452;453;56;397;3299
20220331;635;286;193;34;159;3300
20220621;962;819;482;214;268;3301
20230204;741;876;77;11;66;3302
20221119;360;876;207;55;152;3303
20230623;25;837;268;202;66;3304
20230712;966;876;386;325;61;3305
20220731;442;858;71;27;44;3306
20220425;966;351;447;307;140;3307
20230816;442;354;135;63;72;3308
20220807;855;541;378;157;221;3309
20220219;105;307;403;353;50;3310
20220718;387;647;347;289;58;3311
20230408;597;977;328;168;160;3312
20221111;294;876;93;68;25;3313
20220803;105;541;450;292;158;3314
20230906;597;818;447;230;217;3315
20220223;741;720;279;17;262;3316
20230419;162;567;235;90;145;3317
20211029;962;837;56;39;17;3318
20220821;181;567;416;80;336;3319
20220302;25;354;247;244;3;3320
20221104;597;286;234;41;193;3321
20211023;855;858;231;168;63;3322
20220723;442;286;104;38;66;3323
20230506;962;977;399;164;235;3324
20221227;442;647;290;219;71;3325
20221201;524;825;443;220;223;3326
20230703;63;541;395;229;166;3327
20221226;181;876;76;12;64;3328
20230208;25;354;451;135;316;3329
20220216;580;354;437;40;397;3330
20211025;634;977;89;42;47;3331
20220820;597;307;93;64;29;3332
20230629;63;204;224;171;53;3333
20230912;524;647;148;12;136;3334
20221213;181;204;119;23;96;3335
20221005;360;204;387;365;22;3336
20230807;442;721;185;27;158;3337
20220606;360;720;483;435;48;3338
20230426;181;876;328;328;0;3339
20220913;63;977;487;32;455;3340
20221204;580;647;344;214;130;3341
20221123;162;308;319;19;300;3342
20220120;156;567;260;116;144;3343
20221023;360;837;213;90;123;3344
20220911;635;837;413;128;285;3345
20230816;634;647;317;199;118;3346
20220716;855;204;101;14;87;3347
20230402;597;720;233;171;62;3348
20220114;156;351;421;378;43;3349
20221114;962;858;335;60;275;3350
20220422;360;452;396;246;150;3351
20230902;962;308;468;410;58;3352
20220517;741;308;110;12;98;3353
20230727;294;818;451;287;164;3354
20220415;63;567;139;136;3;3355
20220909;580;647;232;126;106;3356
20230712;524;452;275;12;263;3357
20221230;196;858;467;144;323;3358
20230820;597;818;495;306;189;3359
20220202;855;647;67;67;0;3360
20220906;294;354;95;93;2;3361
20220321;962;721;189;120;69;3362
20220815;741;720;409;77;332;3363
20230524;955;647;124;116;8;3364
20220217;360;307;278;79;199;3365
20230331;196;351;429;184;245;3366
20230211;580;307;333;244;89;3367
20211118;156;351;84;58;26;3368
20220208;162;286;108;49;59;3369
20221207;741;307;458;367;91;3370
20221118;63;858;97;84;13;3371
20230927;63;354;347;77;270;3372
20220517;597;307;466;325;141;3373
20220131;442;720;295;61;234;3374
20231108;966;286;154;103;51;3375
20220608;966;819;263;180;83;3376
20221203;634;647;437;67;370;3377
20221011;63;307;465;78;387;3378
20230414;634;307;205;48;157;3379
20230709;196;825;384;189;195;3380
20221012;597;977;237;89;148;3381
20220207;955;858;127;17;110;3382
20220915;580;567;429;427;2;3383
20220702;524;452;248;186;62;3384
20220518;741;354;201;88;113;3385
20230829;181;204;346;279;67;3386
20230424;105;307;394;285;109;3387
20221012;955;818;422;375;47;3388
20230831;63;567;405;19;386;3389
20230709;105;818;81;65;16;3390
20220607;580;647;273;126;147;3391
20220710;855;286;105;78;27;3392
20230617;741;720;190;100;90;3393
20220903;387;721;144;22;122;3394
20220205;387;351;255;30;225;3395
20220930;156;354;408;274;134;3396
20220802;294;351;61;42;19;3397
20220914;524;818;86;84;2;3398
20230308;966;567;304;239;65;3399
20220510;196;567;298;220;78;3400
20220129;105;348;71;71;0;3401
20211028;597;977;185;68;117;3402
20220530;196;348;423;127;296;3403
20220116;294;452;157;12;145;3404
20221016;962;308;330;316;14;3405
20230809;597;721;185;17;168;3406
20221129;25;354;108;21;87;3407
20230427;635;977;449;201;248;3408
20220513;635;858;396;104;292;3409
20221129;196;876;406;387;19;3410
20220921;442;818;271;251;20;3411
20230827;181;721;273;20;253;3412
20220919;181;204;458;21;437;3413
20231111;360;721;170;103;67;3414
20220117;162;286;432;118;314;3415
20220731;156;858;350;94;256;3416
20221012;955;819;415;208;207;3417
20220420;962;452;143;16;127;3418
20230308;360;819;354;207;147;3419
20220212;635;825;195;105;90;3420
20220219;635;825;453;68;385;3421
20230514;294;351;392;209;183;3422
20230806;162;858;464;464;0;3423
20230911;294;647;282;80;202;3424
20241002;196;307;476;18;458;3425
20220114;580;541;244;144;100;3426
20211124;294;308;373;39;334;3427
20230706;741;837;348;31;317;3428
20220518;597;308;241;105;136;3429
20230707;181;286;305;118;187;3430
20230816;196;541;166;17;149;3431
20220716;196;720;407;343;64;3432
20211003;741;876;218;8;210;3433
20230223;597;286;72;55;17;3434
20220220;634;286;484;85;399;3435
20220909;25;351;276;33;243;3436
20211024;580;977;394;74;320;3437
20241205;156;876;411;111;300;3438
20220313;196;204;76;14;62;3439
20230310;962;567;207;201;6;3440
20220707;966;348;346;5;341;3441
20220809;634;647;279;142;137;3442
20230315;360;351;54;27;27;3443
20240208;196;825;180;180;0;3444
20230117;181;452;258;132;126;3445
20211129;360;354;185;161;24;3446
20230216;741;977;396;328;68;3447
20211109;966;720;149;18;131;3448
20230403;63;567;150;100;50;3449
20221017;156;858;333;103;230;3450
20220210;63;647;202;58;144;3451
20221015;196;308;118;31;87;3452
20211220;741;721;75;42;33;3453
20230412;294;858;442;129;313;3454
20211101;955;452;450;204;246;3455
20230217;105;825;122;59;63;3456
20231208;634;204;386;165;221;3457
20230107;63;286;315;217;98;3458
20230130;294;351;283;259;24;3459
20211012;294;204;68;6;62;3460
20220509;63;204;258;124;134;3461
20211226;741;452;70;17;53;3462
20221002;162;721;136;90;46;3463
20221218;955;348;415;279;136;3464
20211014;196;858;375;262;113;3465
20231107;635;452;488;374;114;3466
20220120;597;452;499;216;283;3467
20220225;855;876;395;276;119;3468
20220222;387;858;305;287;18;3469
20230526;25;351;259;35;224;3470
20220501;181;354;500;298;202;3471
20230525;25;837;349;249;100;3472
20230506;442;858;430;183;247;3473
20220325;966;351;359;16;343;3474
20220214;63;858;164;106;58;3475
20230821;597;204;126;74;52;3476
20230531;635;354;99;65;34;3477
20230712;196;452;447;69;378;3478
20211110;156;647;171;46;125;3479
20230522;966;567;306;116;190;3480
20211008;63;720;280;246;34;3481
20220102;855;825;62;42;20;3482
20220326;597;977;490;147;343;3483
20221021;635;308;367;313;54;3484
20211003;294;647;465;357;108;3485
20221129;524;204;212;196;16;3486
20211014;156;567;236;233;3;3487
20240607;294;819;406;156;250;3488
20211011;634;354;379;234;145;3489
20220203;962;452;110;63;47;3490
20211130;635;837;193;84;109;3491
20221202;741;837;257;181;76;3492
20220813;580;858;175;55;120;3493
20220920;181;876;369;165;204;3494
20220728;580;721;81;16;65;3495
20220401;181;858;477;130;347;3496
20220709;63;818;96;27;69;3497
20211106;962;876;223;22;201;3498
20220105;597;858;220;198;22;3499
20230522;597;825;76;38;38;3500
20220731;63;819;280;33;247;3501
20230925;181;307;433;363;70;3502
20220412;156;721;359;68;291;3503
20220327;741;354;152;74;78;3504
20220208;580;819;472;404;68;3505
20220310;63;351;204;191;13;3506
20220921;442;567;265;121;144;3507
20220708;580;720;149;1;148;3508
20220614;360;351;142;103;39;3509
20221013;162;348;494;290;204;3510
20230724;156;567;426;186;240;3511
20221111;580;876;326;63;263;3512
20230711;63;567;422;304;118;3513
20230327;181;541;66;50;16;3514
20230505;156;204;345;75;270;3515
20221106;524;819;443;74;369;3516
20240405;855;647;493;224;269;3517
20230612;855;307;54;20;34;3518
20221111;196;354;85;24;61;3519
20220728;955;204;439;129;310;3520
20220401;962;307;266;204;62;3521
20211215;387;825;143;45;98;3522
20230117;105;825;321;233;88;3523
20230221;63;348;372;146;226;3524
20230624;156;351;408;370;38;3525
20220627;442;720;68;4;64;3526
20230302;196;452;272;38;234;3527
20230604;63;818;274;98;176;3528
20220419;741;858;478;145;333;3529
20220525;442;308;247;152;95;3530
20220110;105;720;141;128;13;3531
20230412;181;977;291;220;71;3532
20210512;962;286;361;136;225;3533
20230318;524;452;51;49;2;3534
20220119;63;819;214;189;25;3535
20221014;442;204;204;85;119;3536
20220702;962;858;144;62;82;3537
20230616;955;647;171;165;6;3538
20220704;162;307;167;18;149;3539
20240408;442;204;116;92;24;3540
20230607;955;308;176;176;0;3541
20230730;634;720;55;35;20;3542
20220920;855;452;184;50;134;3543
20230902;63;307;389;56;333;3544
20230104;105;977;250;161;89;3545
20230130;955;818;464;237;227;3546
20230612;855;721;107;26;81;3547
20220815;524;818;107;32;75;3548
20230609;855;825;313;45;268;3549
20230810;855;837;279;40;239;3550
20230728;524;647;433;79;354;3551
20230520;25;354;333;158;175;3552
20230707;597;720;356;350;6;3553
20220524;156;876;344;259;85;3554
20230618;162;351;369;368;1;3555
20230704;962;876;300;224;76;3556
20211103;855;720;405;384;21;3557
20221214;855;858;84;51;33;3558
20221218;196;348;75;25;50;3559
20230606;442;308;461;58;403;3560
20220312;181;348;313;259;54;3561
20220618;955;308;234;229;5;3562
20220404;966;819;269;250;19;3563
20211123;635;819;246;124;122;3564
20240504;962;858;190;12;178;3565
20220909;25;647;309;101;208;3566
20230103;294;204;468;103;365;3567
20220926;962;858;233;162;71;3568
20221019;955;818;497;339;158;3569
20230901;962;541;244;220;24;3570
20211222;955;567;335;314;21;3571
20240509;442;647;321;8;313;3572
20220525;580;354;74;52;22;3573
20220330;855;354;111;33;78;3574
20220501;162;876;198;159;39;3575
20250203;741;819;102;5;97;3576
20220628;966;876;107;20;87;3577
20230902;105;825;489;310;179;3578
20230924;962;286;293;162;131;3579
20220322;387;977;269;119;150;3580
20211116;966;348;180;34;146;3581
20220519;181;354;297;158;139;3582
20230610;196;858;341;215;126;3583
20230122;524;286;200;31;169;3584
20220908;294;819;244;211;33;3585
20220920;524;452;318;78;240;3586
20220924;294;837;342;298;44;3587
20230912;294;452;62;9;53;3588
20220605;580;876;56;9;47;3589
20210510;181;818;82;35;47;3590
20230610;524;876;175;4;171;3591
20220601;162;204;396;273;123;3592
20230608;294;977;118;13;105;3593
20230614;294;819;462;427;35;3594
20230118;63;876;83;22;61;3595
20230809;855;721;481;143;338;3596
20230615;294;308;187;52;135;3597
20221103;63;837;294;42;252;3598
20220203;634;204;464;369;95;3599
20220521;635;977;369;11;358;3600
20230527;635;819;129;84;45;3601
20230517;635;286;266;57;209;3602
20220315;360;720;151;77;74;3603
20230331;966;351;342;200;142;3604
20220518;524;351;180;4;176;3605
20211227;162;720;431;279;152;3606
20221022;156;647;430;161;269;3607
20230923;741;286;154;13;141;3608
20221112;855;825;357;326;31;3609
20220524;634;818;464;32;432;3610
20240303;105;348;390;178;212;3611
20220619;387;858;266;130;136;3612
20220909;294;837;446;339;107;3613
20230620;580;977;344;232;112;3614
20220131;597;720;426;316;110;3615
20220609;25;286;173;123;50;3616
20230622;741;837;423;132;291;3617
20230807;855;351;208;134;74;3618
20220214;294;351;249;165;84;3619
20220910;25;286;387;42;345;3620
20221111;855;354;250;147;103;3621
20221106;741;977;135;64;71;3622
20211102;597;819;107;98;9;3623
20230928;741;837;222;218;4;3624
20230705;196;286;221;159;62;3625
20220417;962;825;261;165;96;3626
20220520;635;354;284;118;166;3627
20220203;294;308;80;72;8;3628
20230611;25;818;142;97;45;3629
20211127;597;858;431;300;131;3630
20220704;105;825;313;84;229;3631
20220620;741;876;456;57;399;3632
20211205;25;541;393;56;337;3633
20220506;855;837;79;28;51;3634
20230810;635;977;96;11;85;3635
20221114;955;825;98;61;37;3636
20220418;962;818;75;68;7;3637
20220609;635;837;160;114;46;3638
20220309;962;876;198;33;165;3639
20230704;741;858;327;9;318;3640
20230913;63;647;460;211;249;3641
20220808;442;567;277;18;259;3642
20230608;360;452;292;243;49;3643
20220717;580;286;482;433;49;3644
20221202;855;720;57;19;38;3645
20220711;634;567;271;85;186;3646
20230405;855;825;119;60;59;3647
20220117;63;541;396;380;16;3648
20230904;387;977;362;346;16;3649
20241102;25;721;129;22;107;3650
20230807;63;204;473;417;56;3651
20230916;63;452;268;214;54;3652
20230331;63;307;61;40;21;3653
20230702;25;348;466;15;451;3654
20230129;162;818;379;332;47;3655
20230801;741;858;205;12;193;3656
20221210;63;818;473;278;195;3657
20220131;962;567;215;148;67;3658
20230321;181;876;183;133;50;3659
20240408;962;647;246;126;120;3660
20230121;294;351;417;202;215;3661
20230430;294;286;204;188;16;3662
20220223;156;819;178;85;93;3663
20230718;156;858;75;54;21;3664
20220117;156;818;445;208;237;3665
20220115;360;977;96;75;21;3666
20230826;741;819;86;26;60;3667
20230512;955;825;480;32;448;3668
20240901;741;837;296;160;136;3669
20211121;524;452;477;65;412;3670
20220114;294;348;75;50;25;3671
20230316;294;348;191;170;21;3672
20220806;634;819;133;91;42;3673
20230310;196;452;267;225;42;3674
20220921;196;720;99;17;82;3675
20230111;524;452;385;171;214;3676
20221012;105;307;256;91;165;3677
20220707;25;348;277;175;102;3678
20211224;966;876;69;14;55;3679
20230803;741;308;382;46;336;3680
20230627;156;307;499;190;309;3681
20230724;360;351;247;164;83;3682
20230705;634;567;496;40;456;3683
20220103;360;351;489;19;470;3684
20230404;634;819;432;239;193;3685
20221123;181;647;488;161;327;3686
20230721;634;876;160;147;13;3687
20220920;25;348;292;9;283;3688
20230702;524;721;262;227;35;3689
20220525;294;307;436;275;161;3690
20230712;741;825;425;226;199;3691
20230111;63;348;194;27;167;3692
20230727;294;720;302;177;125;3693
20211201;524;876;377;255;122;3694
20230705;105;348;401;23;378;3695
20211009;966;977;98;39;59;3696
20221102;442;307;137;104;33;3697
20221002;156;348;95;40;55;3698
20220115;105;452;325;269;56;3699
20220713;855;818;490;414;76;3700
20220210;634;647;147;56;91;3701
20220411;156;825;425;298;127;3702
20211111;196;721;430;67;363;3703
20211016;63;876;431;312;119;3704
20220821;962;286;157;57;100;3705
20220619;955;647;443;63;380;3706
20230208;966;825;69;26;43;3707
20211230;63;286;92;66;26;3708
20211025;181;858;329;28;301;3709
20230303;635;837;235;99;136;3710
20230302;387;286;396;111;285;3711
20230119;25;351;187;134;53;3712
20230717;597;452;370;62;308;3713
20220527;442;720;409;198;211;3714
20220820;294;348;67;1;66;3715
20230409;955;720;378;139;239;3716
20220103;966;567;117;41;76;3717
20230704;955;308;500;311;189;3718
20220712;25;308;314;52;262;3719
20220708;524;308;315;44;271;3720
20230717;294;308;118;55;63;3721
20220819;181;286;476;328;148;3722
20211111;196;567;155;116;39;3723
20220703;741;452;259;45;214;3724
20211116;63;876;236;196;40;3725
20230107;635;541;209;89;120;3726
20220702;181;818;336;280;56;3727
20221115;63;348;180;109;71;3728
20220108;156;286;403;104;299;3729
20230408;63;452;205;80;125;3730
20230603;955;354;94;42;52;3731
20230617;63;348;231;27;204;3732
20221128;63;286;76;72;4;3733
20211215;597;721;253;91;162;3734
20220910;580;837;406;24;382;3735
20211124;105;858;414;105;309;3736
20211101;634;567;198;60;138;3737
20230410;524;308;346;238;108;3738
20230706;635;720;223;52;171;3739
20211113;63;204;190;145;45;3740
20230212;597;858;287;128;159;3741
20221128;156;819;184;160;24;3742
20220108;635;876;466;126;340;3743
20220815;442;354;295;141;154;3744
20220725;966;286;221;190;31;3745
20230102;25;876;124;53;71;3746
20221001;156;647;404;236;168;3747
20211024;162;567;165;85;80;3748
20220814;635;308;147;93;54;3749
20250302;962;721;385;60;325;3750
20230512;162;567;428;285;143;3751
20230704;962;720;444;421;23;3752
20221116;196;647;239;101;138;3753
20221224;25;858;75;69;6;3754
20220319;181;567;170;40;130;3755
20220623;955;348;317;282;35;3756
20220803;580;825;386;44;342;3757
20230823;855;286;330;214;116;3758
20221108;156;876;66;59;7;3759
20230802;294;819;176;49;127;3760
20230206;162;720;394;294;100;3761
20220220;156;819;260;93;167;3762
20211004;360;837;100;61;39;3763
20230625;966;819;352;70;282;3764
20221011;25;307;169;26;143;3765
20220811;524;858;222;214;8;3766
20220819;63;647;347;174;173;3767
20221208;156;351;229;193;36;3768
20250302;63;977;69;19;50;3769
20211112;156;351;412;75;337;3770
20230707;294;286;306;242;64;3771
20230105;181;819;239;107;132;3772
20230630;741;647;449;407;42;3773
20220310;63;348;427;18;409;3774
20211215;442;567;341;15;326;3775
20220712;156;567;456;94;362;3776
20211024;156;818;436;398;38;3777
20220822;580;818;166;22;144;3778
20211013;156;308;159;26;133;3779
20220909;962;825;69;4;65;3780
20220814;524;308;433;431;2;3781
20230425;634;354;53;19;34;3782
20230412;162;876;458;140;318;3783
20230323;524;567;488;6;482;3784
20220609;635;204;379;329;50;3785
20220506;181;567;63;37;26;3786
20211108;524;647;212;110;102;3787
20230813;162;837;101;32;69;3788
20220831;962;977;292;59;233;3789
20211013;741;567;224;191;33;3790
20230610;162;819;306;131;175;3791
20230926;580;351;121;47;74;3792
20221029;181;858;265;201;64;3793
20230813;162;351;283;48;235;3794
20221023;63;837;456;448;8;3795
20211009;63;837;432;409;23;3796
20220107;63;286;464;2;462;3797
20220304;360;354;187;29;158;3798
20230616;634;647;429;27;402;3799
20220717;966;354;405;285;120;3800
20220524;105;977;357;335;22;3801
20220831;741;819;283;5;278;3802
20230703;580;837;309;8;301;3803
20221117;580;308;294;99;195;3804
20220930;196;825;500;106;394;3805
20230517;156;837;102;22;80;3806
20220612;156;825;468;287;181;3807
20220715;955;977;188;176;12;3808
20230703;634;286;184;16;168;3809
20220923;196;837;283;24;259;3810
20230210;387;204;217;170;47;3811
20230509;580;204;189;5;184;3812
20220929;741;720;426;322;104;3813
20230318;966;837;256;22;234;3814
20230713;580;567;282;236;46;3815
20211006;634;354;328;279;49;3816
20221128;294;818;152;143;9;3817
20221004;63;204;111;73;38;3818
20240212;25;541;307;303;4;3819
20220908;162;837;499;246;253;3820
20230619;25;286;90;1;89;3821
20220831;196;541;172;82;90;3822
20230905;63;308;95;60;35;3823
20231003;580;837;209;165;44;3824
20220318;196;819;356;146;210;3825
20220311;741;720;281;44;237;3826
20220829;855;541;358;251;107;3827
20220317;63;825;113;13;100;3828
20230809;294;541;406;21;385;3829
20221224;156;307;479;271;208;3830
20221108;294;876;256;105;151;3831
20220517;442;818;127;11;116;3832
20230505;962;307;306;236;70;3833
20220516;955;647;193;138;55;3834
20230228;855;308;379;41;338;3835
20220908;387;307;443;333;110;3836
20230410;580;818;261;5;256;3837
20221207;580;876;474;230;244;3838
20230525;63;721;278;266;12;3839
20220629;387;348;491;363;128;3840
20230318;597;204;311;22;289;3841
20220827;387;647;316;252;64;3842
20220724;181;351;203;100;103;3843
20230605;63;204;459;105;354;3844
20211016;966;858;146;86;60;3845
20230808;387;837;346;337;9;3846
20220712;105;354;291;41;250;3847
20230206;181;354;413;191;222;3848
20220207;634;452;124;119;5;3849
20220204;25;308;230;127;103;3850
20220315;634;286;287;197;90;3851
20230623;105;348;276;215;61;3852
20230530;634;819;131;52;79;3853
20220410;63;837;344;86;258;3854
20211206;597;720;317;216;101;3855
20220603;181;837;474;138;336;3856
20230203;387;876;250;41;209;3857
20230305;580;818;320;313;7;3858
20220602;580;452;146;96;50;3859
20220808;855;348;291;33;258;3860
20230121;741;308;368;75;293;3861
20220815;294;819;51;40;11;3862
20230316;105;977;403;266;137;3863
20220326;855;819;294;207;87;3864
20211221;63;825;441;282;159;3865
20220226;634;720;164;148;16;3866
20230505;580;541;236;236;0;3867
20220306;635;308;471;359;112;3868
20211202;181;567;226;101;125;3869
20220915;634;825;188;86;102;3870
20220610;524;876;162;72;90;3871
20220510;105;977;363;344;19;3872
20211012;63;721;444;13;431;3873
20241003;962;348;402;3;399;3874
20220420;966;348;74;12;62;3875
20230419;524;819;347;320;27;3876
20221126;156;977;389;134;255;3877
20211228;524;819;490;202;288;3878
20220221;105;354;216;36;180;3879
20230227;63;354;167;11;156;3880
20230117;105;825;179;169;10;3881
20220413;524;307;410;379;31;3882
20220726;855;541;111;8;103;3883
20230317;966;567;55;13;42;3884
20230214;105;452;285;86;199;3885
20230711;966;452;376;102;274;3886
20220503;162;720;464;411;53;3887
20220815;181;819;257;119;138;3888
20230909;524;541;157;50;107;3889
20230430;966;818;436;128;308;3890
20221027;580;354;468;75;393;3891
20221219;360;858;336;301;35;3892
20221106;597;818;86;50;36;3893
20211206;360;204;251;125;126;3894
20230514;162;286;485;153;332;3895
20220604;524;818;217;162;55;3896
20230702;196;204;76;70;6;3897
20221231;634;567;479;211;268;3898
20230419;966;308;96;11;85;3899
20220303;966;721;232;159;73;3900
20230105;966;354;334;306;28;3901
20221115;25;354;137;137;0;3902
20211012;360;876;409;56;353;3903
20221209;196;837;400;357;43;3904
20221017;962;348;229;84;145;3905
20230707;162;452;332;238;94;3906
20230216;25;351;222;161;61;3907
20230905;156;819;339;256;83;3908
20220804;387;351;142;51;91;3909
20220830;524;819;180;175;5;3910
20230726;105;567;426;199;227;3911
20220615;634;351;431;208;223;3912
20221130;955;876;89;56;33;3913
20220322;524;819;466;229;237;3914
20230923;634;647;207;193;14;3915
20221105;524;452;243;96;147;3916
20211101;855;541;340;110;230;3917
20220706;156;567;86;63;23;3918
20220818;855;837;252;195;57;3919
20240612;294;452;374;91;283;3920
20220604;442;348;127;72;55;3921
20230318;855;819;300;107;193;3922
20221026;962;825;187;164;23;3923
20220329;360;825;91;68;23;3924
20211029;580;308;374;374;0;3925
20220321;63;567;394;392;2;3926
20221205;360;977;408;403;5;3927
20220712;25;977;351;52;299;3928
20230524;741;720;147;64;83;3929
20240307;955;977;67;58;9;3930
20230214;955;720;465;357;108;3931
20220817;387;825;408;13;395;3932
20220210;181;837;409;145;264;3933
20220904;360;977;256;15;241;3934
20230927;196;858;455;385;70;3935
20211126;634;567;217;145;72;3936
20221011;962;647;478;261;217;3937
20211209;955;876;150;115;35;3938
20230225;294;721;393;153;240;3939
20230717;63;837;268;185;83;3940
20220321;635;307;362;15;347;3941
20220420;387;721;368;311;57;3942
20220418;294;308;481;440;41;3943
20211216;580;858;92;38;54;3944
20220121;442;818;491;289;202;3945
20220206;360;351;432;365;67;3946
20231002;966;837;290;18;272;3947
20230123;741;858;73;11;62;3948
20230226;955;837;498;498;0;3949
20240210;966;720;237;123;114;3950
20220622;634;541;360;276;84;3951
20220416;442;818;177;48;129;3952
20230130;524;818;180;8;172;3953
20230328;741;818;99;11;88;3954
20221202;741;837;193;53;140;3955
20240310;634;876;156;32;124;3956
20220128;25;348;395;179;216;3957
20221013;524;541;91;38;53;3958
20220704;63;721;484;3;481;3959
20230825;196;351;57;34;23;3960
20211124;105;308;456;56;400;3961
20220930;966;837;420;24;396;3962
20221101;580;567;129;4;125;3963
20211214;63;977;151;131;20;3964
20230709;955;819;437;126;311;3965
20220608;955;825;235;164;71;3966
20230523;63;348;186;61;125;3967
20220916;741;541;325;41;284;3968
20211024;966;567;498;494;4;3969
20240501;635;977;269;80;189;3970
20220205;580;354;430;169;261;3971
20221208;25;204;302;261;41;3972
20221003;156;354;111;4;107;3973
20221008;25;351;420;229;191;3974
20220603;196;452;425;149;276;3975
20221208;294;837;423;345;78;3976
20221011;387;308;336;14;322;3977
20220909;741;204;457;411;46;3978
20220507;156;541;188;142;46;3979
20230612;442;647;145;116;29;3980
20230920;597;351;354;72;282;3981
20220210;966;567;164;75;89;3982
20230518;580;348;318;288;30;3983
20211112;387;825;283;243;40;3984
20220203;442;286;87;68;19;3985
20220726;524;837;211;194;17;3986
20211206;105;720;417;219;198;3987
20211213;360;351;416;256;160;3988
20230521;741;567;445;350;95;3989
20220902;156;825;130;92;38;3990
20230612;855;567;59;11;48;3991
20220212;442;307;446;110;336;3992
20211013;855;567;281;253;28;3993
20230710;156;837;143;33;110;3994
20230724;156;351;270;61;209;3995
20221230;597;541;99;6;93;3996
20220224;360;567;408;224;184;3997
20221224;294;819;378;215;163;3998
20230529;635;351;146;5;141;3999
20220809;962;647;226;143;83;4000
20230601;855;837;405;318;87;4001
20220804;196;308;117;82;35;4002
20230629;524;858;334;86;248;4003
20230628;196;876;415;206;209;4004
20220914;294;858;405;396;9;4005
20220118;105;348;488;72;416;4006
20220325;196;647;291;254;37;4007
20221007;196;541;488;249;239;4008
20220106;580;876;121;79;42;4009
20230705;955;647;470;457;13;4010
20230513;966;452;87;40;47;4011
20220107;387;204;301;156;145;4012
20230906;105;647;212;65;147;4013
20220414;635;721;174;76;98;4014
20230330;294;354;496;6;490;4015
20230428;580;647;457;90;367;4016
20211104;962;354;328;25;303;4017
20220419;63;452;262;224;38;4018
20240305;294;819;223;64;159;4019
20221004;156;720;89;26;63;4020
20230326;955;720;131;71;60;4021
20230724;580;204;447;429;18;4022
20211103;580;348;215;13;202;4023
20220512;634;876;127;73;54;4024
20220803;156;819;461;430;31;4025
20230316;442;286;365;245;120;4026
20211104;105;541;129;96;33;4027
20220825;966;351;349;114;235;4028
20230520;635;286;254;19;235;4029
20230424;294;647;110;56;54;4030
20211222;962;647;393;60;333;4031
20220406;634;351;395;279;116;4032
20240206;63;720;295;80;215;4033
20220407;181;308;262;191;71;4034
20211115;63;204;65;4;61;4035
20220915;962;354;226;25;201;4036
20230826;580;837;406;389;17;4037
20230830;442;286;396;60;336;4038
20220809;156;308;465;363;102;4039
20221020;634;825;173;94;79;4040
20230423;634;721;337;93;244;4041
20230518;156;818;350;66;284;4042
20230122;63;354;431;124;307;4043
20220826;634;204;75;29;46;4044
20230612;196;351;322;261;61;4045
20230102;181;858;378;42;336;4046
20220709;955;541;376;363;13;4047
20230106;966;348;76;48;28;4048
20221030;162;348;272;103;169;4049
20221127;634;825;246;52;194;4050
20230107;162;286;123;11;112;4051
20230118;162;858;350;147;203;4052
20230811;634;204;217;102;115;4053
20211025;63;286;444;394;50;4054
20220524;955;348;336;26;310;4055
20210710;955;977;423;318;105;4056
20230120;597;720;152;114;38;4057
20221212;955;541;100;32;68;4058
20220811;162;858;360;337;23;4059
20220518;634;351;275;160;115;4060
20220220;63;876;314;301;13;4061
20220718;580;307;418;269;149;4062
20220610;156;876;310;128;182;4063
20220405;294;541;61;25;36;4064
20211213;105;825;374;28;346;4065
20230712;741;721;115;30;85;4066
20230918;63;818;279;46;233;4067
20220716;962;837;294;269;25;4068
20230318;360;308;149;109;40;4069
20230920;360;858;374;50;324;4070
20221205;63;354;364;338;26;4071
20230305;196;819;159;31;128;4072
20220425;196;825;461;358;103;4073
20220806;196;452;270;139;131;4074
20220806;597;818;414;279;135;4075
20220919;966;825;224;83;141;4076
20230122;63;286;439;179;260;4077
20220916;387;452;199;66;133;4078
20230809;524;286;100;45;55;4079
20230926;634;308;135;30;105;4080
20230126;162;567;241;7;234;4081
20211019;741;721;98;49;49;4082
20230909;181;819;194;77;117;4083
20230128;387;721;270;161;109;4084
20221230;63;818;282;175;107;4085
20221205;855;858;311;258;53;4086
20230308;966;307;136;73;63;4087
20230219;580;819;391;168;223;4088
20230714;634;348;480;7;473;4089
20230127;196;977;420;246;174;4090
20230604;105;647;458;284;174;4091
20211003;635;307;183;144;39;4092
20220107;741;977;425;51;374;4093
20221111;597;286;372;95;277;4094
20230102;597;825;423;49;374;4095
20230529;524;818;454;284;170;4096
20220524;635;858;410;217;193;4097
20230813;63;354;351;48;303;4098
20230909;597;351;390;229;161;4099
20230807;524;647;77;75;2;4100
20230417;597;541;62;3;59;4101
20220612;966;977;118;1;117;4102
20211102;360;286;125;7;118;4103
20230614;741;977;405;247;158;4104
20211021;360;876;151;36;115;4105
20210930;524;647;269;121;148;4106
20230604;442;818;376;234;142;4107
20220614;635;647;427;231;196;4108
20220708;156;348;245;26;219;4109
20220107;580;541;80;5;75;4110
20220110;855;307;143;79;64;4111
20230720;360;720;309;227;82;4112
20220603;597;858;102;60;42;4113
20211215;196;647;224;150;74;4114
20230512;966;308;290;208;82;4115
20220521;962;721;348;101;247;4116
20220311;597;567;264;76;188;4117
20220428;597;837;340;5;335;4118
20220905;156;567;352;162;190;4119
20211225;966;858;421;202;219;4120
20211218;634;818;64;57;7;4121
20230609;635;720;201;116;85;4122
20250303;360;858;473;72;401;4123
20220310;524;647;134;10;124;4124
20220806;181;818;341;257;84;4125
20220910;962;721;326;278;48;4126
20240303;634;541;250;217;33;4127
20220511;105;876;159;18;141;4128
20230215;634;307;299;109;190;4129
20230628;25;354;414;20;394;4130
20211003;442;286;211;15;196;4131
20230307;360;541;385;33;352;4132
20221023;25;286;218;182;36;4133
20220414;294;204;113;95;18;4134
20230808;181;567;93;47;46;4135
20231006;63;286;103;16;87;4136
20230729;580;720;53;17;36;4137
20220714;597;837;337;128;209;4138
20220401;955;541;444;363;81;4139
20230530;156;837;143;133;10;4140
20220706;962;541;286;73;213;4141
20220813;580;825;458;400;58;4142
20230628;105;825;282;99;183;4143
20220611;634;351;444;13;431;4144
20230224;524;354;70;52;18;4145
20220201;635;977;309;3;306;4146
20230608;442;721;102;53;49;4147
20240804;597;348;346;57;289;4148
20220725;196;351;471;259;212;4149
20211102;442;567;457;165;292;4150
20220102;962;452;177;32;145;4151
20211010;442;837;434;417;17;4152
20230217;442;819;140;118;22;4153
20220407;962;818;444;257;187;4154
20220402;156;720;132;39;93;4155
20220908;962;204;88;77;11;4156
20211105;580;720;303;204;99;4157
20220718;634;876;476;319;157;4158
20220614;196;354;115;46;69;4159
20221108;360;858;145;95;50;4160
20220921;63;825;148;63;85;4161
20220118;580;721;207;126;81;4162
20220322;294;818;352;81;271;4163
20220924;966;819;203;127;76;4164
20211019;196;977;228;67;161;4165
20230418;105;818;181;24;157;4166
20220211;162;818;194;42;152;4167
20220414;156;858;408;401;7;4168
20220409;635;541;242;238;4;4169
20220923;63;286;422;286;136;4170
20211218;855;825;208;173;35;4171
20220222;955;819;417;382;35;4172
20211119;442;354;368;318;50;4173
20220530;63;452;130;64;66;4174
20220806;855;858;479;38;441;4175
20230403;294;204;457;147;310;4176
20230601;955;307;135;79;56;4177
20230111;955;354;61;7;54;4178
20220904;181;307;226;163;63;4179
20220115;387;452;338;233;105;4180
20220502;597;567;142;68;74;4181
20230507;597;286;149;9;140;4182
20230821;25;286;451;187;264;4183
20230307;162;977;233;189;44;4184
20211024;105;354;179;9;170;4185
20221208;181;647;181;175;6;4186
20230525;442;567;168;127;41;4187
20220705;955;977;330;49;281;4188
20220205;156;720;463;30;433;4189
20230829;25;819;305;258;47;4190
20230928;63;876;187;101;86;4191
20230224;524;567;224;21;203;4192
20220217;955;286;488;34;454;4193
20220929;360;567;386;117;269;4194
20220401;635;876;68;57;11;4195
20211104;387;647;230;117;113;4196
20230507;63;721;276;105;171;4197
20231102;442;348;61;12;49;4198
20220419;634;541;260;8;252;4199
20230111;294;647;446;64;382;4200
20220407;63;286;393;275;118;4201
20211010;855;351;185;106;79;4202
20211222;635;541;479;199;280;4203
20211030;741;721;228;155;73;4204
20230206;387;647;211;56;155;4205
20220513;63;647;95;59;36;4206
20211003;25;204;499;410;89;4207
20230323;294;541;490;381;109;4208
20220810;955;837;244;57;187;4209
20230215;387;876;376;209;167;4210
20230809;741;354;352;132;220;4211
20230424;442;307;132;86;46;4212
20221101;105;647;62;27;35;4213
20230817;387;567;104;57;47;4214
20221014;966;819;489;444;45;4215
20211120;524;351;376;90;286;4216
20220424;524;354;432;218;214;4217
20230623;387;452;463;246;217;4218
20230907;741;720;344;175;169;4219
20230912;181;286;156;154;2;4220
20220630;105;567;287;75;212;4221
20221017;634;647;290;51;239;4222
20220718;962;819;323;127;196;4223
20221010;105;204;318;47;271;4224
20220612;63;452;394;206;188;4225
20230808;741;452;422;395;27;4226
20220122;294;721;417;84;333;4227
20220504;962;720;363;27;336;4228
20221120;387;286;130;26;104;4229
20211115;442;647;443;62;381;4230
20230118;524;452;325;307;18;4231
20220220;855;567;233;178;55;4232
20220404;962;204;335;192;143;4233
20230910;387;351;476;59;417;4234
20221112;741;452;110;32;78;4235
20221124;25;825;343;279;64;4236
20230117;162;307;299;242;57;4237
20220519;105;876;50;6;44;4238
20230310;162;351;166;99;67;4239
20230315;634;825;216;132;84;4240
20211001;442;452;481;152;329;4241
20220122;855;354;432;412;20;4242
20220301;63;308;312;128;184;4243
20221112;855;286;316;197;119;4244
20230310;966;818;57;17;40;4245
20230301;156;818;313;117;196;4246
20220706;442;876;69;28;41;4247
20230202;162;286;117;97;20;4248
20220412;105;837;261;105;156;4249
20221012;634;721;472;28;444;4250
20220809;524;308;107;82;25;4251
20220109;442;977;167;134;33;4252
20220629;955;308;353;137;216;4253
20221219;25;720;123;56;67;4254
20230412;63;818;354;235;119;4255
20211125;955;348;172;133;39;4256
20221026;635;977;403;319;84;4257
20230407;524;720;280;249;31;4258
20230406;597;307;448;373;75;4259
20220824;196;720;302;9;293;4260
20230909;63;351;496;401;95;4261
20220320;635;354;330;250;80;4262
20230907;162;647;236;134;102;4263
20230709;966;541;145;142;3;4264
20221219;442;825;258;49;209;4265
20211130;162;567;175;81;94;4266
20220601;162;819;398;388;10;4267
20230122;360;351;61;52;9;4268
20221125;156;307;268;140;128;4269
20230915;294;354;144;133;11;4270
20220226;196;876;107;104;3;4271
20230325;962;204;442;36;406;4272
20230522;597;825;319;6;313;4273
20211121;524;452;500;143;357;4274
20230922;156;204;222;219;3;4275
20220520;634;721;185;39;146;4276
20230217;63;308;421;47;374;4277
20220218;294;351;120;17;103;4278
20221104;63;977;222;125;97;4279
20221227;962;307;271;215;56;4280
20220513;294;351;460;330;130;4281
20220115;63;307;485;3;482;4282
20230606;360;977;495;208;287;4283
20230823;156;977;242;233;9;4284
20230304;597;647;367;278;89;4285
20220419;63;647;227;164;63;4286
20220710;442;876;228;210;18;4287
20211118;855;567;126;71;55;4288
20221205;294;354;63;25;38;4289
20220726;635;452;334;4;330;4290
20221108;181;977;131;108;23;4291
20230714;524;567;373;303;70;4292
20250707;855;858;257;114;143;4293
20220614;955;541;269;33;236;4294
20211214;580;825;109;93;16;4295
20220723;962;819;269;33;236;4296
20220903;196;307;251;161;90;4297
20230717;855;720;261;139;122;4298
20230824;294;452;460;393;67;4299
20230926;156;837;474;293;181;4300
20230630;741;819;343;68;275;4301
20230208;181;721;218;7;211;4302
20220120;442;308;187;11;176;4303
20220914;360;837;69;45;24;4304
20230417;597;819;265;244;21;4305
20220805;580;204;384;124;260;4306
20230810;966;351;343;220;123;4307
20221224;442;567;85;23;62;4308
20230922;156;452;210;105;105;4309
20230921;962;819;346;40;306;4310
20220131;156;452;164;81;83;4311
20211018;966;348;104;6;98;4312
20220420;25;825;342;128;214;4313
20220111;634;567;100;12;88;4314
20220721;162;818;327;53;274;4315
20230620;63;720;476;99;377;4316
20230704;966;541;454;210;244;4317
20220522;855;876;281;70;211;4318
20220725;634;876;418;378;40;4319
20230905;741;819;124;100;24;4320
20211016;966;307;249;12;237;4321
20220422;524;876;213;80;133;4322
20221214;635;825;72;27;45;4323
20230331;634;348;351;181;170;4324
20221106;580;977;362;108;254;4325
20230808;597;876;283;3;280;4326
20230724;635;647;301;256;45;4327
20230102;634;307;473;202;271;4328
20220418;387;837;149;113;36;4329
20220728;162;977;64;38;26;4330
20220630;597;204;469;43;426;4331
20230322;360;720;417;305;112;4332
20230108;855;307;117;32;85;4333
20220806;63;721;187;24;163;4334
20220408;442;819;427;395;32;4335
20230819;580;647;219;60;159;4336
20211201;63;308;435;173;262;4337
20220329;597;858;432;260;172;4338
20221024;294;720;276;218;58;4339
20220430;741;567;173;160;13;4340
20230710;63;348;400;288;112;4341
20230507;634;308;328;40;288;4342
20211031;855;286;492;459;33;4343
20220313;294;818;150;27;123;4344
20220208;162;286;96;54;42;4345
20230423;105;567;226;168;58;4346
20220816;63;354;325;97;228;4347
20221217;634;720;346;289;57;4348
20220807;597;647;388;53;335;4349
20211001;25;307;384;227;157;4350
20220417;294;286;224;172;52;4351
20240102;63;977;279;88;191;4352
20230702;962;307;328;204;124;4353
20230908;962;837;178;138;40;4354
20220131;634;837;180;117;63;4355
20220814;25;354;105;61;44;4356
20220814;360;977;323;184;139;4357
20211103;524;721;51;34;17;4358
20220921;966;825;293;142;151;4359
20220529;63;286;493;107;386;4360
20230909;63;204;281;3;278;4361
20231202;597;721;68;32;36;4362
20230210;63;307;409;335;74;4363
20230121;63;647;297;43;254;4364
20220410;634;720;166;97;69;4365
20221106;966;567;76;18;58;4366
20220417;442;354;460;302;158;4367
20221003;360;307;363;108;255;4368
20221105;294;567;210;147;63;4369
20221010;181;452;409;121;288;4370
20230117;962;858;286;118;168;4371
20220828;162;308;388;365;23;4372
20230510;955;720;352;178;174;4373
20220107;196;204;440;141;299;4374
20221024;966;354;271;204;67;4375
20220622;63;308;347;103;244;4376
20230610;360;818;108;69;39;4377
20220425;962;348;215;120;95;4378
20221004;855;307;118;22;96;4379
20230712;105;307;497;68;429;4380
20211209;955;452;373;145;228;4381
20230331;442;354;476;380;96;4382
20221202;387;204;350;48;302;4383
20230618;442;307;62;11;51;4384
20221104;635;819;218;80;138;4385
20230530;156;837;247;103;144;4386
20230618;741;837;436;319;117;4387
20211020;855;308;181;141;40;4388
20211205;634;307;183;117;66;4389
20230916;962;720;366;163;203;4390
20230607;294;204;499;127;372;4391
20220302;580;876;319;110;209;4392
20220907;635;452;52;3;49;4393
20220907;387;541;125;119;6;4394
20230304;63;567;200;98;102;4395
20241009;962;567;481;223;258;4396
20220602;360;354;73;9;64;4397
20230722;635;354;72;5;67;4398
20221218;25;858;351;349;2;4399
20230414;105;720;115;50;65;4400
20221003;105;858;354;137;217;4401
20211012;580;818;74;74;0;4402
20230621;966;721;449;35;414;4403
20220221;855;452;488;274;214;4404
20240402;105;858;433;362;71;4405
20230607;962;721;456;241;215;4406
20221012;105;286;73;54;19;4407
20220826;962;348;225;102;123;4408
20211206;156;818;158;117;41;4409
20230812;25;818;347;102;245;4410
20230122;966;204;369;75;294;4411
20211220;105;647;458;440;18;4412
20221127;294;204;430;312;118;4413
20220410;294;351;364;353;11;4414
20220702;25;351;356;46;310;4415
20220513;962;825;100;41;59;4416
20220625;442;286;265;161;104;4417
20220503;635;858;445;178;267;4418
20221114;360;308;350;129;221;4419
20220109;196;818;181;20;161;4420
20220410;635;858;430;352;78;4421
20230206;360;818;185;151;34;4422
20220501;63;858;162;123;39;4423
20230224;162;351;193;112;81;4424
20211014;966;307;55;17;38;4425
20221108;196;307;459;353;106;4426
20220314;196;286;447;348;99;4427
20221116;25;825;69;65;4;4428
20221028;25;825;240;54;186;4429
20230130;855;858;121;110;11;4430
20230104;162;858;108;41;67;4431
20230802;442;720;111;14;97;4432
20220422;635;647;349;246;103;4433
20220331;294;452;108;65;43;4434
20240809;966;977;191;171;20;4435
20221212;156;858;136;21;115;4436
20220330;524;977;232;133;99;4437
20230807;63;977;223;136;87;4438
20211123;63;204;384;339;45;4439
20230818;955;351;172;156;16;4440
20221016;63;308;309;99;210;4441
20211114;387;977;213;85;128;4442
20230401;634;720;392;58;334;4443
20230501;196;647;127;88;39;4444
20221003;634;647;274;74;200;4445
20220913;63;721;477;127;350;4446
20220610;524;541;332;199;133;4447
20230920;156;307;165;116;49;4448
20230207;25;348;228;201;27;4449
20230414;294;720;164;45;119;4450
20220526;955;647;397;62;335;4451
20230823;63;977;305;55;250;4452
20220530;196;307;475;334;141;4453
20220610;634;452;227;23;204;4454
20220208;360;819;359;323;36;4455
20221029;387;837;192;118;74;4456
20230225;524;286;228;134;94;4457
20220703;25;819;94;17;77;4458
20211109;25;354;298;116;182;4459
20220306;162;837;413;234;179;4460
20220216;442;977;56;17;39;4461
20220328;63;567;222;206;16;4462
20230905;196;876;255;140;115;4463
20230218;196;837;290;101;189;4464
20221115;955;647;396;66;330;4465
20221206;360;818;185;168;17;4466
20211130;955;825;84;75;9;4467
20230310;635;307;254;168;86;4468
20220209;855;348;349;235;114;4469
20221128;63;876;71;39;32;4470
20230305;162;541;101;40;61;4471
20230224;156;307;63;49;14;4472
20220417;360;348;277;59;218;4473
20230128;597;837;70;51;19;4474
20221219;855;204;240;21;219;4475
20230418;635;541;447;327;120;4476
20221224;294;204;185;25;160;4477
20220707;580;647;307;158;149;4478
20230330;635;819;493;112;381;4479
20221004;597;977;168;123;45;4480
20230326;162;307;445;204;241;4481
20230717;597;825;412;395;17;4482
20221011;63;721;82;5;77;4483
20220421;580;876;250;198;52;4484
20211008;634;720;281;173;108;4485
20230918;597;351;267;241;26;4486
20230914;524;647;321;76;245;4487
20230510;524;567;71;38;33;4488
20230127;63;876;150;109;41;4489
20211105;294;818;406;333;73;4490
20230527;156;286;452;404;48;4491
20230320;360;818;471;393;78;4492
20220120;25;567;315;71;244;4493
20230403;360;308;134;8;126;4494
20220403;25;977;464;454;10;4495
20220704;597;647;69;65;4;4496
20220603;105;351;69;13;56;4497
20220928;962;721;341;13;328;4498
20230408;955;837;241;139;102;4499
20220523;105;837;236;146;90;4500
20230409;580;354;393;216;177;4501
20220317;955;308;156;110;46;4502
20211017;63;567;127;98;29;4503
20220629;966;308;81;2;79;4504
20230927;387;348;211;98;113;4505
20230125;962;647;223;41;182;4506
20230718;63;837;492;170;322;4507
20221122;387;721;119;82;37;4508
20220513;105;307;161;80;81;4509
20231001;580;825;190;132;58;4510
20211002;741;307;365;321;44;4511
20230411;25;876;217;167;50;4512
20230609;162;286;382;295;87;4513
20211001;162;819;430;347;83;4514
20230110;442;308;74;32;42;4515
20221205;966;819;284;200;84;4516
20220316;63;286;95;61;34;4517
20220412;855;819;72;58;14;4518
20211101;294;721;396;260;136;4519
20230820;294;647;411;343;68;4520
20220912;955;819;354;170;184;4521
20220427;524;819;472;390;82;4522
20230803;156;818;52;21;31;4523
20230405;25;307;261;77;184;4524
20221207;741;721;451;393;58;4525
20230122;524;354;262;46;216;4526
20230417;181;348;347;232;115;4527
20220716;634;647;483;107;376;4528
20220329;387;837;108;51;57;4529
20221031;105;819;151;61;90;4530
20221226;634;354;122;98;24;4531
20230507;196;286;461;394;67;4532
20230529;966;308;416;255;161;4533
20230915;955;837;116;116;0;4534
20221202;635;351;265;173;92;4535
20230125;524;858;404;141;263;4536
20220611;597;837;330;282;48;4537
20220706;25;204;421;73;348;4538
20220516;597;308;471;251;220;4539
20231009;25;720;368;141;227;4540
20230602;181;876;494;259;235;4541
20220712;634;721;367;187;180;4542
20220628;741;541;131;23;108;4543
20230629;597;541;161;20;141;4544
20220205;635;286;276;72;204;4545
20230807;63;858;426;376;50;4546
20211002;524;721;245;179;66;4547
20230521;634;307;472;73;399;4548
20230424;25;286;202;42;160;4549
20220517;294;837;171;71;100;4550
20230814;162;977;487;151;336;4551
20230312;635;647;221;8;213;4552
20221219;634;819;138;69;69;4553
20230713;741;351;479;23;456;4554
20220528;442;647;109;98;11;4555
20220429;162;308;105;56;49;4556
20250503;294;819;200;48;152;4557
20210930;181;452;405;320;85;4558
20230723;25;567;58;24;34;4559
20230717;442;858;288;16;272;4560
20230522;162;452;429;347;82;4561
20230607;634;286;363;264;99;4562
20211212;156;204;364;65;299;4563
20230724;156;452;397;294;103;4564
20230217;156;837;301;54;247;4565
20211012;162;825;50;50;0;4566
20230525;524;308;472;222;250;4567
20220414;360;286;229;2;227;4568
20230908;63;825;255;171;84;4569
20220218;25;721;338;111;227;4570
20230507;181;647;259;67;192;4571
20230817;741;541;177;33;144;4572
20230502;741;721;456;60;396;4573
20220105;360;647;356;97;259;4574
20221103;181;818;465;265;200;4575
20230724;635;876;324;182;142;4576
20220728;294;351;470;293;177;4577
20221102;955;977;77;56;21;4578
20221223;442;721;378;122;256;4579
20230328;741;647;200;15;185;4580
20230724;387;567;404;402;2;4581
20220409;105;825;492;282;210;4582
20220605;634;721;295;79;216;4583
20230216;63;818;441;229;212;4584
20230910;181;977;342;174;168;4585
20220729;597;307;367;132;235;4586
20220530;524;818;189;187;2;4587
20211217;196;308;220;118;102;4588
20220817;580;858;153;49;104;4589
20230621;63;721;141;133;8;4590
20220611;580;354;162;18;144;4591
20230114;635;977;465;95;370;4592
20211206;156;819;448;184;264;4593
20220322;524;567;421;210;211;4594
20211113;196;351;380;285;95;4595
20220118;181;818;176;157;19;4596
20220605;635;308;317;84;233;4597
20220110;442;286;60;30;30;4598
20230402;387;348;207;136;71;4599
20211024;63;348;213;67;146;4600
20220731;181;567;85;23;62;4601
20240109;63;720;460;147;313;4602
20220518;387;720;135;91;44;4603
20230817;855;825;146;113;33;4604
20220606;962;837;69;51;18;4605
20220107;105;567;478;320;158;4606
20220327;597;977;317;160;157;4607
20230617;597;307;50;41;9;4608
20220307;196;819;254;96;158;4609
20230430;741;286;108;14;94;4610
20230720;105;720;52;51;1;4611
20220908;196;351;53;24;29;4612
20220530;156;977;171;97;74;4613
20220110;580;286;347;235;112;4614
20230104;294;351;290;266;24;4615
20211104;105;567;92;22;70;4616
20220310;162;720;295;181;114;4617
20220208;962;720;438;99;339;4618
20221221;105;354;74;39;35;4619
20221125;634;354;233;188;45;4620
20230918;196;977;255;98;157;4621
20211116;597;351;101;5;96;4622
20220411;105;647;96;96;0;4623
20220606;442;567;391;243;148;4624
20230222;387;351;256;165;91;4625
20220423;962;876;70;30;40;4626
20211009;105;452;432;53;379;4627
20230319;25;307;312;12;300;4628
20220929;63;819;386;247;139;4629
20220916;741;819;410;230;180;4630
20211107;962;647;217;82;135;4631
20230315;634;348;443;442;1;4632
20211105;63;721;228;39;189;4633
20221113;635;286;454;243;211;4634
20220119;855;977;385;205;180;4635
20221025;634;307;125;116;9;4636
20220827;25;647;473;317;156;4637
20220604;634;308;370;15;355;4638
20220803;25;307;217;118;99;4639
20220419;360;204;409;31;378;4640
20230818;63;647;163;81;82;4641
20220429;955;825;51;25;26;4642
20220511;105;720;142;138;4;4643
20220911;181;351;452;347;105;4644
20230925;524;204;366;125;241;4645
20230701;855;354;200;69;131;4646
20250102;162;308;246;61;185;4647
20230909;635;876;286;261;25;4648
20230529;294;351;418;102;316;4649
20220202;442;308;100;44;56;4650
20220607;597;204;121;68;53;4651
20211027;955;721;279;96;183;4652
20220111;294;721;170;77;93;4653
20221210;597;452;492;376;116;4654
20211130;966;348;52;52;0;4655
20230224;63;647;372;115;257;4656
20230101;442;977;341;30;311;4657
20230104;741;204;130;2;128;4658
20230112;580;818;92;54;38;4659
20230629;855;819;252;240;12;4660
20220310;635;837;275;250;25;4661
20220503;25;721;409;146;263;4662
20220913;580;721;359;74;285;4663
20230621;25;977;434;106;328;4664
20220328;966;721;317;90;227;4665
20221121;105;818;397;162;235;4666
20220630;962;567;230;129;101;4667
20221120;156;452;109;28;81;4668
20241104;25;721;337;269;68;4669
20220109;196;720;496;421;75;4670
20220516;597;354;405;52;353;4671
20230404;196;977;328;104;224;4672
20230220;294;204;291;58;233;4673
20221218;25;825;308;100;208;4674
20220630;597;286;433;25;408;4675
20220405;442;308;464;421;43;4676
20221026;360;354;401;72;329;4677
20221127;580;720;462;376;86;4678
20230404;63;876;325;194;131;4679
20230705;63;204;197;73;124;4680
20230308;580;307;487;213;274;4681
20211002;63;286;173;88;85;4682
20221228;105;825;339;4;335;4683
20220905;196;818;335;127;208;4684
20230729;634;837;432;265;167;4685
20220529;955;351;334;128;206;4686
20230310;387;567;51;10;41;4687
20230612;25;348;200;186;14;4688
20220722;955;977;226;224;2;4689
20221017;597;354;437;302;135;4690
20220301;63;825;304;7;297;4691
20220602;962;876;313;276;37;4692
20221226;966;541;186;69;117;4693
20230913;105;977;175;22;153;4694
20211120;524;818;143;7;136;4695
20230804;105;541;235;44;191;4696
20211205;741;351;106;58;48;4697
20230315;25;354;334;138;196;4698
20221029;63;567;341;160;181;4699
20211101;63;876;146;7;139;4700
20230508;63;351;318;97;221;4701
20230110;387;348;336;144;192;4702
20221017;181;858;409;83;326;4703
20220720;387;819;105;60;45;4704
20221028;156;452;343;262;81;4705
20220109;196;567;219;124;95;4706
20221105;387;720;375;238;137;4707
20230301;105;452;357;316;41;4708
20240311;162;351;143;7;136;4709
20230119;741;647;273;35;238;4710
20230928;635;354;276;222;54;4711
20220306;955;307;91;53;38;4712
20220607;524;825;233;118;115;4713
20211111;181;825;138;62;76;4714
20230331;105;720;111;12;99;4715
20211127;741;286;112;49;63;4716
20220504;63;819;465;174;291;4717
20230128;580;452;337;315;22;4718
20230725;597;647;140;76;64;4719
20221124;360;858;439;273;166;4720
20230204;25;876;398;233;165;4721
20221027;524;837;427;216;211;4722
20221122;294;204;403;272;131;4723
20230807;634;351;351;342;9;4724
20220203;962;977;330;279;51;4725
20230921;196;204;423;211;212;4726
20221105;181;825;150;66;84;4727
20230924;387;567;386;175;211;4728
20221018;962;204;97;87;10;4729
20230314;855;825;124;4;120;4730
20230730;162;204;358;58;300;4731
20211019;196;354;322;130;192;4732
20211225;966;647;266;176;90;4733
20221126;962;354;98;68;30;4734
20211116;597;818;185;60;125;4735
20230110;162;977;125;32;93;4736
20230630;25;204;60;56;4;4737
20221203;156;825;216;55;161;4738
20221010;156;837;399;7;392;4739
20230526;597;825;407;157;250;4740
20220317;156;977;111;69;42;4741
20220718;105;647;328;168;160;4742
20220315;181;721;103;10;93;4743
20211111;360;977;98;34;64;4744
20230709;63;307;347;265;82;4745
20220820;162;858;170;67;103;4746
20230108;181;307;203;124;79;4747
20221204;105;204;184;75;109;4748
20230825;25;204;158;141;17;4749
20230405;597;977;258;25;233;4750
20220920;634;567;123;110;13;4751
20230207;387;348;73;10;63;4752
20221112;955;307;145;115;30;4753
20211220;360;818;166;158;8;4754
20230407;442;647;120;107;13;4755
20230719;634;567;220;66;154;4756
20250206;634;818;61;48;13;4757
20211108;162;348;241;134;107;4758
20220327;25;308;480;338;142;4759
20220919;741;567;466;421;45;4760
20230517;105;348;405;346;59;4761
20211127;360;348;393;309;84;4762
20211009;962;647;281;167;114;4763
20220415;156;286;456;40;416;4764
20230915;387;541;432;194;238;4765
20240205;162;837;421;169;252;4766
20230329;63;647;401;16;385;4767
20211207;955;204;105;96;9;4768
20220728;741;858;355;346;9;4769
20220129;962;308;422;378;44;4770
20220525;442;977;192;125;67;4771
20240701;63;837;471;62;409;4772
20220701;442;286;325;244;81;4773
20220518;360;647;147;123;24;4774
20220904;741;977;494;268;226;4775
20220627;63;308;270;183;87;4776
20211103;635;818;276;226;50;4777
20211207;162;647;398;262;136;4778
20220426;387;647;149;105;44;4779
20230228;294;308;139;45;94;4780
20221117;181;977;163;143;20;4781
20230531;196;837;366;282;84;4782
20220319;387;825;405;382;23;4783
20230504;955;721;128;57;71;4784
20211116;25;204;475;335;140;4785
20220125;597;825;321;47;274;4786
20230523;156;452;202;67;135;4787
20210411;360;452;428;355;73;4788
20230515;387;818;261;152;109;4789
20220923;855;541;129;42;87;4790
20230910;635;647;280;100;180;4791
20221117;597;720;221;71;150;4792
20220401;962;818;66;31;35;4793
20230704;966;858;69;47;22;4794
20230807;156;354;435;77;358;4795
20211213;597;307;349;200;149;4796
20220914;442;351;308;23;285;4797
20220521;524;308;271;83;188;4798
20230710;962;720;177;130;47;4799
20230307;524;837;485;1;484;4800
20220811;196;348;378;186;192;4801
20230822;442;818;187;48;139;4802
20230707;635;452;347;68;279;4803
20220517;63;308;399;324;75;4804
20211225;387;837;454;66;388;4805
20230326;966;721;124;105;19;4806
20220615;966;567;343;188;155;4807
20230519;156;307;267;121;146;4808
20230619;962;308;379;99;280;4809
20220521;387;351;164;114;50;4810
20220317;635;286;153;47;106;4811
20221025;597;977;178;55;123;4812
20231007;524;837;222;31;191;4813
20220416;360;858;282;274;8;4814
20230611;580;354;463;113;350;4815
20230615;105;837;281;130;151;4816
20220129;741;818;307;190;117;4817
20211108;63;541;176;80;96;4818
20220622;962;647;53;19;34;4819
20230716;360;721;229;21;208;4820
20221013;635;286;304;246;58;4821
20240206;162;837;72;1;71;4822
20220729;955;348;355;301;54;4823
20220913;294;977;481;384;97;4824
20221029;387;825;263;204;59;4825
20220507;63;977;217;36;181;4826
20220608;181;720;216;190;26;4827
20220623;360;354;157;122;35;4828
20221005;962;858;70;12;58;4829
20240508;162;348;276;209;67;4830
20220207;294;858;140;4;136;4831
20220521;597;308;120;93;27;4832
20230324;63;858;486;77;409;4833
20220116;156;876;378;364;14;4834
20220214;442;541;96;59;37;4835
20230707;181;837;61;11;50;4836
20230204;962;286;442;335;107;4837
20230609;442;204;75;13;62;4838
20230225;63;204;417;130;287;4839
20211002;955;204;112;87;25;4840
20220806;25;647;108;49;59;4841
20220725;580;977;248;36;212;4842
20211019;25;567;50;50;0;4843
20220319;855;819;350;125;225;4844
20230820;156;351;164;73;91;4845
20230404;634;819;254;253;1;4846
20220219;25;286;472;73;399;4847
20230819;741;977;351;197;154;4848
20220101;63;876;150;71;79;4849
20230321;962;307;367;233;134;4850
20220527;105;541;80;46;34;4851
20230506;294;307;114;101;13;4852
20211114;634;721;439;249;190;4853
20230627;634;286;239;71;168;4854
20220119;741;541;348;241;107;4855
20230623;442;720;428;84;344;4856
20230818;442;721;285;283;2;4857
20221014;360;647;435;367;68;4858
20230920;360;819;249;99;150;4859
20211001;855;647;500;214;286;4860
20220318;196;541;348;242;106;4861
20220923;966;977;200;23;177;4862
20230506;156;307;329;163;166;4863
20211220;25;977;252;56;196;4864
20230228;387;351;336;240;96;4865
20220602;162;541;223;21;202;4866
20221002;966;819;163;77;86;4867
20220304;634;204;211;20;191;4868
20221004;156;876;466;326;140;4869
20220323;524;351;372;361;11;4870
20220925;105;647;320;291;29;4871
20230601;387;858;195;138;57;4872
20220606;524;819;89;38;51;4873
20220206;294;351;231;11;220;4874
20240203;25;541;139;99;40;4875
20211123;524;837;362;136;226;4876
20220312;634;977;338;233;105;4877
20210410;741;858;72;61;11;4878
20230312;387;876;415;130;285;4879
20230704;105;819;230;182;48;4880
20211217;442;837;290;43;247;4881
20230415;580;567;73;26;47;4882
20220601;387;204;232;124;108;4883
20220515;524;308;172;94;78;4884
20230516;634;837;481;182;299;4885
20211218;634;286;112;6;106;4886
20220922;741;720;497;376;121;4887
20230806;442;876;339;238;101;4888
20220216;63;541;112;26;86;4889
20220311;442;541;150;126;24;4890
20230719;63;541;312;96;216;4891
20221117;196;286;188;70;118;4892
20221115;196;876;433;58;375;4893
20220908;181;647;496;8;488;4894
20230622;524;354;206;147;59;4895
20220323;360;541;283;140;143;4896
20230622;387;541;182;33;149;4897
20211211;294;876;77;67;10;4898
20220723;25;837;434;299;135;4899
20220821;635;354;301;55;246;4900
20230127;63;825;478;321;157;4901
20230219;360;307;219;36;183;4902
20230805;63;720;106;12;94;4903
20230826;635;858;284;59;225;4904
20230423;597;204;268;213;55;4905
20231111;966;567;144;38;106;4906
20211229;196;876;79;36;43;4907
20220920;156;452;224;214;10;4908
20230103;63;452;281;16;265;4909
20230509;580;308;388;94;294;4910
20230307;955;308;480;287;193;4911
20220422;955;286;246;3;243;4912
20220814;580;858;434;358;76;4913
20221121;966;452;484;107;377;4914
20221130;162;286;366;92;274;4915
20220610;162;977;491;245;246;4916
20220612;196;567;258;144;114;4917
20221025;196;977;319;245;74;4918
20220610;855;452;68;58;10;4919
20230518;181;308;230;215;15;4920
20230729;741;721;407;397;10;4921
20230729;63;720;143;25;118;4922
20240901;634;977;383;117;266;4923
20230303;156;307;455;166;289;4924
20220117;634;825;328;89;239;4925
20220220;181;567;450;270;180;4926
20230616;181;351;477;176;301;4927
20211120;855;837;491;486;5;4928
20220821;855;351;208;193;15;4929
20211126;181;837;98;71;27;4930
20230723;580;452;158;45;113;4931
20230814;63;567;336;140;196;4932
20220510;955;647;193;103;90;4933
20220502;294;308;296;131;165;4934
20230704;442;286;481;76;405;4935
20230601;63;541;464;373;91;4936
20230308;294;818;334;283;51;4937
20220909;162;286;354;211;143;4938
20221220;360;286;76;38;38;4939
20220904;105;286;467;415;52;4940
20220210;105;286;65;39;26;4941
20230328;635;819;356;279;77;4942
20230429;196;825;455;402;53;4943
20230918;294;351;324;66;258;4944
20230813;955;308;357;144;213;4945
20230313;63;858;165;90;75;4946
20221107;105;351;280;152;128;4947
20211209;196;818;386;157;229;4948
20220622;597;720;306;3;303;4949
20220323;442;567;175;15;160;4950
20221123;580;721;226;87;139;4951
20230729;855;308;436;174;262;4952
20230715;580;567;326;302;24;4953
20220408;634;348;182;31;151;4954
20220916;162;354;419;392;27;4955
20211028;962;720;307;102;205;4956
20220707;966;876;268;185;83;4957
20220806;25;308;418;340;78;4958
20220427;387;876;225;44;181;4959
20220728;196;858;480;251;229;4960
20220327;105;286;431;72;359;4961
20221122;580;452;157;43;114;4962
20220425;25;977;294;168;126;4963
20230715;955;858;318;6;312;4964
20230902;181;567;429;360;69;4965
20211122;63;837;196;127;69;4966
20220510;181;308;384;297;87;4967
20230603;580;720;158;125;33;4968
20230626;635;720;200;191;9;4969
20220611;196;721;70;55;15;4970
20220424;962;308;462;443;19;4971
20230207;63;286;444;211;233;4972
20230531;855;721;476;105;371;4973
20230330;196;307;371;189;182;4974
20220727;294;351;378;240;138;4975
20240906;105;567;248;4;244;4976
20220214;25;308;415;412;3;4977
20230806;524;876;450;99;351;4978
20220110;855;286;61;57;4;4979
20220430;741;354;126;45;81;4980
20230201;63;204;427;272;155;4981
20220707;63;647;389;221;168;4982
20211124;741;858;397;106;291;4983
20231105;105;876;164;73;91;4984
20211209;597;858;139;32;107;4985
20220425;387;307;339;39;300;4986
20221212;360;204;70;62;8;4987
20230721;855;876;182;61;121;4988
20221104;962;819;302;103;199;4989
20230718;597;977;406;305;101;4990
20220911;634;307;93;18;75;4991
20220218;962;721;367;39;328;4992
20210929;105;348;113;90;23;4993
20211115;105;837;109;80;29;4994
20230325;855;819;287;260;27;4995
20230516;63;204;113;2;111;4996
20230909;360;721;373;192;181;4997
20221203;635;286;133;38;95;4998
20221006;387;351;181;49;132;4999
20230824;105;348;401;359;42;5000
20230824;105;348;401;359;42;5001
20230824;105;348;401;359;42;5002
20230824;105;348;401;359;42;5003
20230824;105;348;401;359;42;5004
20230824;105;348;401;359;42;5005
20230824;105;348;401;359;42;5006
20230824;105;348;401;359;42;5007
20230824;105;348;401;359;42;5008
20230824;105;348;401;359;42;5009
20230824;105;348;401;359;42;5010
